date,tweet_id,post_date,comment_num,retweet_num,like_num,Subjuctivity,Polarity,Class_sentiment_negative,Class_sentiment_neutral,Class_sentiment_positive,tweet_count,total_count_tweet
2015-01-01,7.102568434384267e+19,183193554413,45,699,190,59.50809523809524,-37.26642857142857,55,59,15,129,828
2015-01-02,9.312152872271508e+19,240015013196,10,371,88,44.1065404040404,3.8253156565656568,35,89,45,169,540
2015-01-03,3.85931236303023e+19,99419765892,3,11,52,12.579978354978355,3.4556998556998564,10,45,15,70,81
2015-01-04,4.579198228937846e+19,117890962207,3,24,43,16.978333333333335,4.8425,8,58,17,83,107
2015-01-05,1.5403171609518853e+20,396308980682,14,53,130,56.148953823953825,22.61985028860029,22,186,71,279,332
2015-01-06,1.1435925761912078e+20,294054211360,11,66,139,53.99637987012987,16.08712031024531,25,119,63,207,273
2015-01-07,1.083503897923789e+20,278444400921,8,39,168,41.702579365079366,6.01569264069264,31,111,54,196,235
2015-01-08,1.1893650247992387e+20,305456191366,26,38,111,51.9446645021645,15.267732683982683,27,118,70,215,253
2015-01-09,1.1071376945547218e+20,284163214435,17,20,85,43.8566341991342,12.635176767676768,24,117,59,200,220
2015-01-10,3.5999516717321003e+19,92357226944,2,8,58,4.994629629629629,0.9199999999999999,1,53,11,65,73
2015-01-11,2.881937298402403e+19,73890492615,1,2,48,10.799166666666666,3.8008333333333337,4,32,16,52,54
2015-01-12,1.2589789219361602e+20,322581935706,35,79,184,63.804990079365076,24.509412878787877,21,122,84,227,306
2015-01-13,2.2866341723846823e+20,585517616378,46,173,263,114.58244047619047,37.008988095238095,39,206,167,412,585
2015-01-14,1.5827624080207544e+20,405053964066,36,85,128,77.67778596403596,21.304366605616604,30,158,97,285,370
2015-01-15,1.522680880750395e+20,389444324119,17,51,86,54.5703391053391,20.916996753246753,15,183,76,274,325
2015-01-16,1.8350839965071078e+20,469067353355,16,63,107,45.759207551707554,6.1822186147186144,33,244,53,330,393
2015-01-17,5.230301399974532e+19,133620497849,8,18,36,18.921823593073594,3.761672077922078,13,58,23,94,112
2015-01-18,4.175701268251892e+19,106618270696,6,5,55,11.639999999999999,5.868333333333333,9,51,15,75,80
2015-01-19,6.519035473496659e+19,166336283725,11,36,88,27.75077561327561,10.457891414141413,10,66,41,117,153
2015-01-20,1.2600430382755902e+20,321318471238,17,85,97,63.933800505050506,17.78558080808081,30,120,76,226,311
2015-01-21,2.8119371555796002e+20,716614633084,101,260,303,142.20385702260702,45.95410353535353,63,266,175,504,764
2015-01-22,3.03151267642394e+20,772114285460,47,74,139,83.03015512265512,18.85253427128427,41,394,108,543,617
2015-01-23,2.2233657090242534e+20,565965489017,36,101,148,58.729492544492544,24.543665223665222,23,297,78,398,499
2015-01-24,6.930853757998624e+19,176339979839,15,22,52,24.341372053872053,7.755600649350649,7,80,37,124,146
2015-01-25,4.9218020932732666e+19,125151968340,5,18,43,12.07595238095238,3.411168831168831,5,58,25,88,106
2015-01-26,1.0802160404199568e+20,274499507356,51,108,189,42.242741702741704,10.415140692640692,14,137,42,193,301
2015-01-27,1.3945849482867573e+20,354169404746,13,48,96,53.17500541125541,17.5249044011544,20,161,68,249,297
2015-01-28,1.6700879540472624e+20,423890822003,25,67,81,59.500207431457426,19.198710317460318,20,195,83,298,365
2015-01-29,6.276173840744794e+20,1591841981017,281,858,726,308.80404923779923,98.31860243922743,129,603,387,1119,1977
2015-01-30,7.210607596291059e+20,1828067223556,260,606,762,350.05411365486367,86.91684668109669,185,694,406,1285,1891
2015-01-31,9.656981284803255e+19,244703653119,22,61,108,32.25800324675325,10.749420995670995,16,107,49,172,233
2015-02-01,6.685963546168232e+19,169311941218,23,104,129,27.375714285714285,8.067242063492063,22,66,31,119,223
2015-02-02,1.9566818974246997e+20,495165502777,52,88,161,82.35742424242424,30.305319264069265,30,217,101,348,436
2015-02-03,2.5148539728194096e+20,636068024526,37,193,197,93.78472041847041,35.275236291486294,36,279,132,447,640
2015-02-04,1.638224889758754e+20,414109302528,29,110,147,57.30565656565656,19.76719696969697,20,200,71,291,401
2015-02-05,2.112545365788463e+20,533680121762,50,83,175,96.1366847041847,35.81250360750361,37,206,132,375,458
2015-02-06,1.0258554304040901e+20,259026264710,15,36,71,46.85620490620491,15.534758297258296,19,102,61,182,218
2015-02-07,5.0762725457604444e+19,128097924549,12,82,111,17.880357142857143,8.616666666666667,5,65,20,90,172
2015-02-08,4.571650658230485e+19,115295297446,4,13,32,15.472570346320346,8.458003246753247,3,59,19,81,94
2015-02-09,1.0617791156219147e+20,267615761943,22,29,87,41.50388888888889,15.973492063492063,12,130,46,188,217
2015-02-10,1.0229100991220847e+20,257667207566,14,46,102,46.71310606060606,16.743712121212123,12,110,59,181,227
2015-02-11,1.0348923634813313e+20,260530556960,12,62,72,41.0033658008658,14.851179653679653,23,113,47,183,245
2015-02-12,1.0751490892523518e+20,270512196910,12,20,72,43.04637085137085,11.332435064935066,19,118,53,190,210
2015-02-13,1.189118191077092e+20,299006131525,20,28,70,44.22114552114552,16.393118686868686,9,140,61,210,238
2015-02-14,5.3256842834787434e+19,133847908367,8,19,31,12.869473304473305,4.862770562770562,4,73,17,94,113
2015-02-15,9.12743549658107e+19,229263932858,3,22,39,21.071082251082252,10.595205627705628,4,122,35,161,183
2015-02-16,6.694120062597961e+19,168042552886,31,89,120,20.399022366522367,10.086782106782106,6,80,32,118,207
2015-02-17,7.607143748760797e+19,190840730569,11,34,71,32.0679329004329,7.314852092352092,18,79,37,134,168
2015-02-18,1.1418290128665698e+20,286279154887,10,37,55,44.774292929292926,8.36415404040404,25,122,54,201,238
2015-02-19,1.648396789482813e+20,413062984535,27,41,152,65.33190295815295,12.9373566017316,32,186,72,290,331
2015-02-20,1.5412835308398137e+20,386021340944,23,40,126,53.15168831168831,11.918863636363636,26,179,66,271,311
2015-02-21,6.032219413104522e+19,150998439075,11,15,60,11.016969696969696,3.239090909090909,6,85,15,106,121
2015-02-22,4.840490186952778e+19,121091600727,29,36,94,16.89328282828283,4.739040404040404,7,59,19,85,121
2015-02-23,9.801597221068277e+19,245048444380,19,136,125,40.75853174603174,14.935912698412698,14,105,53,172,308
2015-02-24,8.43908878810951e+19,210867931754,10,42,152,37.15471112221112,13.749867632367632,16,91,41,148,190
2015-02-25,1.449286240701288e+20,361917760057,40,99,146,70.62148809523809,29.588445165945163,21,134,99,254,353
2015-02-26,1.4101972249978076e+20,351963960486,26,55,158,49.294408369408366,15.23044733044733,20,160,67,247,302
2015-02-27,1.0911378585277376e+20,272182233843,31,231,186,34.28707431457431,7.491046176046176,9,140,42,191,422
2015-02-28,5.373251951184164e+19,133961318524,10,16,41,19.444702380952382,6.962061688311688,6,53,35,94,110
2015-03-01,4.232655010506211e+19,105465224024,6,30,42,8.491771284271284,3.2031782106782107,4,61,9,74,104
2015-03-02,1.1619673100879231e+20,289336959255,38,64,145,41.150003607503606,15.20595238095238,11,137,55,203,267
2015-03-03,1.305856899706522e+20,324988428767,15,62,125,51.361217532467535,18.155384199134197,17,141,70,228,290
2015-03-04,1.5817858382636443e+20,393431166069,31,69,124,47.125811688311686,7.019345238095238,29,188,59,276,345
2015-03-05,1.6688307894804532e+20,414839004039,29,56,137,50.89680375180375,8.719494648869649,21,211,59,291,347
2015-03-06,1.6067128917538803e+20,399180813245,22,81,171,40.466085858585856,7.185934343434344,24,211,45,280,361
2015-03-07,7.865884169508905e+19,195324120725,8,11,65,12.439583333333333,2.834431818181818,4,115,18,137,148
2015-03-08,4.022002377422548e+19,99807649109,1,6,26,13.188333333333333,3.1900757575757575,5,50,15,70,76
2015-03-09,1.2705876104311236e+20,315125698559,15,71,129,36.316528138528135,5.91260606060606,20,159,42,221,292
2015-03-10,1.1160493738034735e+20,276642675578,7,23,143,26.05743867243867,6.236094877344877,14,152,28,194,217
2015-03-11,1.2145796128479899e+20,300902014092,26,70,71,40.7562518037518,6.736244588744588,25,137,49,211,281
2015-03-12,1.1174470858021216e+20,276675999631,5,35,59,50.89421933621934,8.04168344155844,23,122,49,194,229
2015-03-13,9.509798828569405e+19,235330897974,7,54,94,28.712171717171717,6.588093434343434,12,121,32,165,219
2015-03-14,7.497034963184116e+19,185422870875,3,117,42,26.6489898989899,8.89006734006734,3,88,39,130,247
2015-03-15,5.0783458919737745e+19,125525197845,3,8,20,15.931309523809523,8.135140692640693,3,58,27,88,96
2015-03-16,1.270457426822106e+20,313833759765,25,67,164,33.39089993339993,7.124714313464313,15,168,37,220,287
2015-03-17,1.4618568185570528e+20,360928631012,10,26,36,32.429559884559886,9.617445887445887,10,202,41,253,279
2015-03-18,1.2373486206510848e+20,305311374465,13,49,77,38.94922577422577,19.880207292707293,7,146,61,214,263
2015-03-19,1.6431452579801098e+20,405204768422,34,482,247,46.23439393939394,15.363603896103896,17,205,62,284,766
2015-03-20,1.9682835225477582e+20,485131427277,18,305,138,59.22883111333111,19.819765012765014,16,242,82,340,645
2015-03-21,9.267970644066866e+19,228310159781,4,12,20,31.993787878787877,11.138636363636364,11,115,34,160,172
2015-03-22,5.622255022108736e+19,138421493030,2,15,21,27.545324675324675,16.794502164502163,8,48,41,97,112
2015-03-23,8.526057249151205e+19,209786445747,10,20,59,34.505248917748915,11.63284632034632,15,94,38,147,167
2015-03-24,1.3522696849959944e+20,332539170671,22,108,85,43.91633838383838,7.112503607503607,27,158,48,233,341
2015-03-25,1.3821192112384888e+20,339695013705,18,56,75,54.93274891774892,10.320854978354978,43,130,65,238,294
2015-03-26,1.4410691345288007e+20,353988839132,15,127,118,52.936388888888885,17.76581168831169,28,149,71,248,375
2015-03-27,1.6280600061588976e+20,399689768097,22,59,112,59.733582251082254,17.736132756132758,29,171,80,280,339
2015-03-28,9.311229986551697e+18,22841329808,1,1,5,3.5107142857142857,1.666396103896104,0,11,5,16,17
2015-03-29,5.123176234056879e+19,125632081706,15,20,27,18.909444444444446,5.221111111111111,2,68,18,88,108
2015-03-30,1.2000789597664874e+20,294112116711,18,53,75,50.4690367965368,11.355205627705628,29,115,62,206,259
2015-03-31,1.876982334910961e+20,459755607804,19,80,109,75.11388708513708,22.832370129870128,31,200,91,322,402
2015-04-01,1.5514579307602015e+20,379819742660,24,76,116,59.59875541125541,19.95055916305916,16,171,79,266,342
2015-04-02,1.4065281655288688e+20,344143473441,12,86,112,42.066551226551226,13.804218975468975,17,176,48,241,327
2015-04-03,8.3512560748357e+19,204214347371,8,14,22,23.5125,9.720833333333333,10,100,33,143,157
2015-04-04,5.843216115258166e+19,142814810250,3,4,19,13.167045454545455,1.8227272727272725,4,83,13,100,104
2015-04-05,6.607402726972445e+19,161391627768,3,986,203,21.065079365079367,7.954761904761904,6,84,23,113,1099
2015-04-06,1.0004932443247885e+20,244244398350,9,46,102,43.06583333333333,18.945575396825397,13,104,54,171,217
2015-04-07,9.073950093628445e+19,221403403877,15,35,97,34.822680375180376,12.695234487734487,11,97,47,155,190
2015-04-08,1.4821341588676333e+20,361412080481,10,60,143,50.28948051948052,16.210844155844153,13,172,68,253,313
2015-04-09,1.8757486313159495e+20,457148524071,17,68,180,67.84151848151848,8.987501110001109,34,207,79,320,388
2015-04-10,1.4135277362100217e+20,344310356216,40,126,177,64.68491702741703,11.912781385281384,22,137,82,241,367
2015-04-11,7.805705524382161e+19,190025303769,8,27,57,22.481872294372295,4.697240259740259,10,99,24,133,160
2015-04-12,6.16578557501576e+19,150028050646,1,10,47,18.143024891774893,6.092472943722943,5,74,26,105,115
2015-04-13,1.1869786785666569e+20,288644441780,16,67,171,45.876150793650794,9.196865079365079,23,120,59,202,269
2015-04-14,1.681581537888442e+20,408698830704,18,50,113,61.0584163059163,16.57910173160173,15,193,78,286,336
2015-04-15,1.5414485281308082e+20,374425760014,32,69,166,70.17980375180375,12.829269119769119,28,160,74,262,331
2015-04-16,1.3834080509347113e+20,335859237099,10,49,153,62.34758658008658,13.583840788840789,25,143,67,235,284
2015-04-17,1.6375872280236025e+20,397339244820,31,112,166,62.73308080808081,8.397348484848484,39,172,67,278,390
2015-04-18,6.0119464248832705e+19,145794764604,11,31,44,11.076666666666666,2.5566666666666666,3,88,11,102,133
2015-04-19,7.844255544084885e+19,190117214180,6,51,65,25.383809523809525,4.006666666666667,12,104,17,133,184
2015-04-20,2.1540997133191037e+20,521782504854,55,308,370,77.86115800865801,20.326838023088023,46,227,92,365,673
2015-04-21,1.4704788994043553e+20,355978857536,65,99,107,51.711204906204905,18.380804473304472,19,160,70,249,348
2015-04-22,1.8849061756601447e+20,456078021980,29,117,149,71.96155844155844,15.838658008658008,37,197,85,319,436
2015-04-23,8.224997693521128e+20,1988868675374,446,1162,1394,359.7977362914863,86.04880230880231,190,774,427,1391,2553
2015-04-24,9.891591405985835e+20,2390765993590,489,836,1204,428.7759707237207,127.34291670829171,201,935,536,1672,2508
2015-04-25,2.065796604377864e+20,499055835085,87,285,623,64.37404341029341,17.917175324675323,31,233,85,349,634
2015-04-26,1.0720824908435866e+20,258839568732,18,86,97,35.46228354978355,12.018143939393939,14,121,46,181,267
2015-04-27,2.6848273787210183e+20,647853516171,60,106,174,91.0713064019314,32.54354333166833,53,285,115,453,559
2015-04-28,2.075649298717185e+20,500579576608,58,100,143,67.99477633477633,27.525497835497834,17,238,95,350,450
2015-04-29,1.750570560847852e+20,421943171948,27,32,78,52.9999531024531,15.804908008658009,17,216,62,295,327
2015-04-30,1.6506674269378337e+20,397651101070,32,26,62,62.51432928182928,16.908188131313132,30,171,77,278,304
2015-05-01,1.5268795115839776e+20,367634232719,50,46,71,61.61051046176046,19.278963744588744,30,148,79,257,303
2015-05-02,4.399596086324383e+19,105863242561,2,5,39,15.535101010101009,5.412878787878787,6,50,18,74,79
2015-05-03,5.948867058385113e+18,14306670173,0,0,0,2.993181818181818,0.8787878787878788,0,8,2,10,10
2015-05-04,1.3809072320008677e+20,331933108019,23,51,106,39.700887445887446,12.481444805194805,19,170,43,232,283
2015-05-05,1.9534960188291246e+20,469312846032,49,60,79,65.61692640692641,16.07114357864358,25,227,76,328,388
2015-05-06,2.044057590086228e+20,490804526757,23,69,79,76.82582611832612,15.869989177489177,38,221,84,343,412
2015-05-07,1.6517231666797792e+20,396387436883,25,48,148,56.29176226551227,16.95013888888889,21,186,70,277,325
2015-05-08,1.7004445749439116e+20,407859725570,11,45,88,56.01557359307359,17.175560966810966,14,199,72,285,330
2015-05-09,9.313187417465065e+19,223262625078,2,10,25,20.321724386724387,4.478239538239539,9,123,24,156,166
2015-05-10,8.54247656432007e+19,204670252539,5,8,24,23.304372294372293,12.355800865800866,12,103,28,143,151
2015-05-11,1.590027142511149e+20,380739304322,35,43,75,46.704134199134195,9.404595959595959,36,176,54,266,309
2015-05-12,1.3816231761800502e+20,330661342477,19,15,40,35.94523448773449,10.810699855699855,14,171,46,231,246
2015-05-13,1.2987107381820362e+20,310640866280,11,29,64,35.445631313131315,8.213892496392496,21,161,35,217,246
2015-05-14,1.6229855631589088e+20,387969269176,25,32,75,40.4062518037518,10.95439935064935,21,196,54,271,303
2015-05-15,1.785721152735684e+20,426647732291,18,49,67,49.38962842712843,1.9285353535353533,39,212,47,298,347
2015-05-16,1.936461387622842e+20,462462533898,9,42,75,32.76574675324675,1.5182359307359308,20,271,32,323,365
2015-05-17,1.6737702291782753e+20,399490749768,2,6,28,29.543737373737372,13.550454545454546,5,238,36,279,285
2015-05-18,2.1008742291774282e+20,501180985812,17,27,69,54.981516955266954,15.595912097162097,32,254,64,350,377
2015-05-19,1.5737641093573037e+20,375196223509,46,44,115,45.59033189033189,15.15661976911977,20,183,59,262,306
2015-05-20,2.73454186676482e+20,651616471881,15,32,92,62.29743867243867,14.270947871572872,32,355,68,455,487
2015-05-21,2.940687745443244e+20,700351761746,31,105,147,97.6581313131313,25.909554473304475,37,347,105,489,594
2015-05-22,2.340655315682495e+20,557162376402,23,62,120,58.79106782106782,12.695764790764793,37,294,58,389,451
2015-05-23,1.3847069067616344e+20,329446029364,4,13,30,37.360649350649346,5.53512987012987,21,165,44,230,243
2015-05-24,4.578483805854602e+19,108867414072,8,48,39,11.98598124098124,1.9550721500721502,10,51,15,76,124
2015-05-25,1.663837623049489e+20,395387433063,6,40,60,32.39455988455988,2.2896933621933626,21,221,34,276,316
2015-05-26,2.5273323262454704e+20,600278152377,17,88,74,83.10806277056277,-22.045418470418472,60,299,60,419,507
2015-05-27,1.7684426154887984e+20,419791604982,27,88,89,65.39783189033189,13.237927489177487,26,188,79,293,381
2015-05-28,2.2586047787359096e+20,535873614531,26,100,145,84.7069610944611,25.43473655973656,23,239,112,374,474
2015-05-29,2.2357627466279466e+20,530173678169,15,57,94,81.87911616161615,20.743633658008658,27,245,98,370,427
2015-05-30,1.7835954842995304e+20,422730547474,6,121,118,59.11123376623377,16.507489177489177,19,214,62,295,416
2015-05-31,1.4216848347450271e+20,336771826738,2,12,15,45.643484848484846,11.92621212121212,11,164,60,235,247
2015-06-01,2.2034914423885257e+20,521671260473,12,36,75,69.4019264069264,17.408373015873014,23,259,82,364,400
2015-06-02,2.1442006226949197e+20,507369307421,20,42,77,66.1207683982684,13.883488455988456,23,249,82,354,396
2015-06-03,2.733464502558948e+20,646435445617,33,115,162,94.73327200577201,22.385814093314092,33,296,122,451,566
2015-06-04,2.0618515453210454e+20,487362262789,10,48,74,70.35017857142857,18.226309523809523,23,222,95,340,388
2015-06-05,2.08123517845099e+20,491690909537,15,25,89,57.77168747918748,8.655407647907648,26,245,72,343,368
2015-06-06,4.978591171919426e+19,117554354211,2,14,30,19.517857142857142,6.485714285714287,13,38,31,82,96
2015-06-07,9.539092246018995e+19,225090059140,3,18,39,26.979713203463202,5.309843073593075,15,106,36,157,175
2015-06-08,2.170120591437255e+20,511853792563,10,90,106,69.39957287157287,15.644528860028862,36,239,82,357,447
2015-06-09,2.5850773329603255e+20,609387910475,18,55,114,80.98270923520923,16.028131313131315,45,283,97,425,480
2015-06-10,2.4162465589860424e+20,569275291877,14,47,94,86.493508991009,23.257754329004328,42,245,110,397,444
2015-06-11,3.203253646284904e+20,754298714708,29,67,134,102.12034992784993,22.26413780663781,47,353,126,526,593
2015-06-12,2.0900108808005894e+20,491900138588,9,29,28,64.44692640692641,11.390059523809525,34,245,64,343,372
2015-06-13,3.902164930693852e+19,91788924530,1,7,15,14.530194805194805,4.082873376623376,7,32,25,64,71
2015-06-14,1.1835009523848662e+20,278250846534,4,13,25,36.38920634920635,7.362579365079365,18,135,41,194,207
2015-06-15,2.2647542201404018e+20,532153723730,8,83,103,67.56574425574425,11.250690004440004,31,262,78,371,454
2015-06-16,2.4432160958487737e+20,573784800676,29,218,202,73.78759046509046,18.866370851370853,24,280,96,400,618
2015-06-17,2.35904061440343e+20,553734211159,21,91,128,72.71828893328893,22.31018398268398,24,272,90,386,477
2015-06-18,3.1004482514766135e+20,727359778558,39,81,141,105.55599386724387,32.472002164502165,40,326,141,507,588
2015-06-19,2.4658372039704514e+20,578190634822,25,78,107,83.07784451659451,15.340553751803752,30,273,100,403,481
2015-06-20,1.763152368425288e+20,413221300801,4,16,42,40.56681818181818,8.421912878787879,7,225,56,288,304
2015-06-21,1.3844729425109765e+20,324285111332,6,28,46,35.15169372294372,7.675156926406926,10,180,36,226,254
2015-06-22,2.3231373334802534e+20,543856365423,10,143,118,66.54753246753246,15.445604256854256,21,285,73,379,522
2015-06-23,3.2446776621055666e+20,759152845112,47,134,171,128.54997113997115,31.690165945165944,61,302,166,529,663
2015-06-24,2.755424338496411e+20,644381338955,10,49,96,88.36129725829726,22.40111075036075,31,293,125,449,498
2015-06-25,2.9106349503643792e+20,680302722661,20,65,134,101.69410173160173,32.4383170995671,26,310,138,474,539
2015-06-26,2.2794662062868103e+20,532504484811,5,39,34,70.94965223665223,22.04708297258297,13,252,106,371,410
2015-06-27,1.8996708807218476e+20,443541690225,4,22,55,58.28066378066378,16.48311688311688,5,240,64,309,331
2015-06-28,1.888531428820918e+20,440698435048,8,51,67,53.52334235209235,16.302036435786437,6,233,68,307,358
2015-06-29,2.1974755425493464e+20,512505985414,7,45,60,72.59825216450216,21.53250541125541,16,239,102,357,402
2015-06-30,3.2024721103481176e+20,746547071562,20,101,105,92.94615079365079,20.17388888888889,33,373,114,520,621
2015-07-01,2.1566636977415825e+20,502511110400,10,88,95,70.80230158730159,19.678849206349206,16,253,81,350,438
2015-07-02,1.0173827050265356e+20,236914064633,11,9,34,37.470151515151514,12.725299422799424,8,110,47,165,174
2015-07-03,1.597865824420927e+20,371904348256,3,38,36,33.73892135642136,8.106569264069265,7,213,39,259,297
2015-07-04,1.691399498384245e+20,393466889428,1,4,11,51.50422799422799,7.169816017316018,14,209,51,274,278
2015-07-05,5.126106152483198e+19,119194892305,2,23,33,19.96168831168831,5.225649350649351,4,53,26,83,106
2015-07-06,1.1990235234127598e+20,278620933466,18,87,123,66.93877344877345,21.2331240981241,29,87,78,194,281
2015-07-07,2.5168233571897757e+20,584561579350,12,81,120,83.0160149110149,18.848562409812413,29,286,92,407,488
2015-07-08,9.90020270737772e+19,229817518486,8,37,36,42.450679413179415,12.475473484848484,17,91,52,160,197
2015-07-09,9.163261097249648e+19,212594493085,9,38,47,31.3957215007215,8.547478354978356,27,86,35,148,186
2015-07-10,2.2240678078868636e+20,515717664375,16,32,105,62.27998617123617,17.773290043290043,30,266,63,359,391
2015-07-11,2.2065957870339496e+20,511434594017,6,29,78,57.01821428571428,13.017463924963925,18,258,80,356,385
2015-07-12,1.5257159724615133e+20,353429307062,11,50,105,35.22110028860028,8.928683261183261,13,192,41,246,296
2015-07-13,2.6065545748460064e+20,603455792956,50,232,347,114.28868145743145,36.18550324675324,40,219,161,420,652
2015-07-14,3.260015994643585e+20,754363199570,52,275,363,130.61634879009878,45.32993131868132,54,305,166,525,800
2015-07-15,5.051110313253562e+20,1168250688357,93,287,399,196.72829485329484,68.1505275974026,89,480,244,813,1100
2015-07-16,3.6367817901913657e+20,840676094570,60,246,314,138.21560976060977,29.97557178932179,86,336,163,585,831
2015-07-17,2.3948108450578992e+20,553298204941,91,649,714,102.38508838383838,33.96743205868206,47,212,126,385,1034
2015-07-18,8.961723669091692e+19,206958650513,12,43,73,33.14128968253968,12.045615079365081,21,85,38,144,187
2015-07-19,9.279393147504792e+19,214160208441,17,62,162,42.977362914862915,19.511462842712845,23,68,58,149,211
2015-07-20,3.7074094668612154e+20,855248339341,61,267,404,127.65220418470419,44.1077886002886,58,381,156,595,862
2015-07-21,2.7370263112302553e+20,631054346057,50,105,218,89.16507515632516,32.337750721500726,46,284,109,439,544
2015-07-22,2.8821965540663253e+20,664158678771,29,67,188,91.65626443001443,31.366264430014432,35,310,117,462,529
2015-07-23,1.4414631196334096e+21,3319591544140,624,2223,2277,639.1716500675251,143.5650606060606,401,1189,719,2309,4532
2015-07-24,1.4308610537868047e+21,3293864785095,400,1253,1781,670.0502491489991,215.98175535113035,253,1187,851,2291,3544
2015-07-25,2.6495047226682864e+20,609635144169,21,109,164,71.50739898989899,18.915689033189032,38,301,85,424,533
2015-07-26,9.691647992533493e+19,222876110438,27,92,181,48.00361111111111,17.913704906204906,20,69,66,155,247
2015-07-27,2.615291894168052e+20,601086436934,43,162,261,117.28034992784993,38.724015151515154,49,225,144,418,580
2015-07-28,3.0800260852447196e+20,707540351578,41,138,185,124.1815255115255,34.38971681096681,47,283,162,492,630
2015-07-29,3.513938046499684e+20,806815232106,42,221,233,107.46746886446886,36.710133741258744,42,376,143,561,782
2015-07-30,3.196464140952701e+20,733515480684,46,194,176,107.5899025974026,34.652536075036075,29,325,156,510,704
2015-07-31,2.721586579024444e+20,624242059284,25,60,96,69.69154581529581,24.85375541125541,16,320,98,434,494
2015-08-01,1.5748779076135816e+20,361045593810,10,124,110,41.4589898989899,8.325723905723905,12,194,45,251,375
2015-08-02,1.6762130682373413e+20,384082971910,6,42,39,31.698156565656564,7.11284632034632,9,214,44,267,309
2015-08-03,2.3871118823253076e+20,546670472491,24,277,202,74.60337181337181,20.177801226551228,30,253,97,380,657
2015-08-04,1.5525252527205564e+20,355357325090,24,77,122,66.0492971981722,17.44131277056277,35,115,97,247,324
2015-08-05,2.0188518804634183e+20,461849206382,25,66,111,68.05440776815776,20.97733225108225,27,190,104,321,387
2015-08-06,2.7059228703561423e+20,618713267472,22,60,128,76.15151154401154,20.697800024050025,30,292,108,430,490
2015-08-07,2.9466584554148885e+20,673428580111,30,107,180,87.31104978354978,23.871904761904762,36,333,99,468,575
2015-08-08,8.693066949519324e+19,198585113135,3,12,23,23.56840548340548,8.004664502164502,7,91,40,138,150
2015-08-09,1.4057355239464278e+20,320925545857,8,15,50,16.10038961038961,6.05033189033189,5,190,28,223,238
2015-08-10,1.3623845373036578e+20,310870132975,25,76,128,44.4538455988456,13.354588744588742,14,137,65,216,292
2015-08-11,1.7355223914877167e+20,395807696140,24,57,135,41.17075877825878,15.44142857142857,14,199,62,275,332
2015-08-12,1.5912534015843097e+20,362724850985,19,75,110,48.82507936507936,11.495992063492062,20,175,57,252,327
2015-08-13,2.2555845759289508e+20,513891412732,13,28,81,58.896812715062715,8.377404040404041,25,265,67,357,385
2015-08-14,2.345269633729093e+20,534073360785,22,80,200,45.68541967291967,11.708820346320346,13,307,51,371,451
2015-08-15,2.239233231586395e+20,509635061391,18,36,119,59.769374098124096,18.72128246753247,6,275,73,354,390
2015-08-16,9.746385308069976e+19,221717779391,26,112,192,52.51106421356421,14.616569264069266,27,68,59,154,266
2015-08-17,2.7484685804106406e+20,624882976151,58,224,321,130.48989357864357,24.72655964405964,63,214,157,434,658
2015-08-18,2.4394439520825315e+20,554362341142,39,118,208,87.6437425074925,20.697302697302696,47,231,107,385,503
2015-08-19,2.0920798395445078e+20,475194611743,16,79,155,83.36604474229475,25.17930167055167,29,183,118,330,409
2015-08-20,1.484424520398307e+20,336978822443,34,74,171,61.411802849927845,9.423983585858585,43,121,70,234,308
2015-08-21,1.8406894567199834e+20,417647598995,52,163,365,75.01188131313131,15.237969877344877,44,158,88,290,453
2015-08-22,4.699259269229393e+19,106577695267,11,58,105,17.12012987012987,5.538419913419913,10,42,22,74,132
2015-08-23,4.1939408237588365e+19,95062242412,8,33,59,15.266580086580086,6.004307359307359,8,35,23,66,99
2015-08-24,1.678516486798202e+20,380271384750,33,150,186,66.38647005772006,14.280358946608946,38,153,73,264,414
2015-08-25,2.2838984761519034e+20,517144138669,54,115,205,77.0935119047619,16.768916847041847,40,222,97,359,474
2015-08-26,4.398387221588924e+20,995450690306,35,152,302,134.9352904040404,24.301663059163058,74,463,154,691,843
2015-08-27,3.955077520524303e+20,894662915216,69,123,199,120.78814935064935,41.18098394660895,47,410,164,621,744
2015-08-28,1.0834741141107009e+20,244933981480,4,16,50,27.964301948051947,3.9610948773448778,11,135,24,170,186
2015-08-29,1.5748144831786962e+20,355888741758,5,17,50,41.34129148629148,10.317445887445887,11,189,47,247,264
2015-08-30,2.322194161673162e+20,524501353828,5,77,63,45.925663780663776,8.95288961038961,15,301,48,364,441
2015-08-31,2.0170391890313396e+20,455361813585,20,64,122,73.49620851370851,18.40157287157287,21,201,94,316,380
2015-09-01,1.711778572458482e+20,386219754561,33,201,157,72.83642135642135,18.33188943001443,43,142,83,268,469
2015-09-02,1.4123742401448704e+20,318506155235,31,117,142,51.69245670995671,8.307642496392496,28,140,53,221,338
2015-09-03,1.5602229810591914e+20,351674348309,17,89,95,57.98352453102453,20.843268398268396,26,137,81,244,333
2015-09-04,1.9193367389589173e+20,432411046068,28,130,100,46.530512265512264,7.560085678210678,33,213,54,300,430
2015-09-05,3.3287067015771935e+19,74955673875,10,36,54,10.987640692640692,1.9732359307359308,6,32,14,52,88
2015-09-06,2.2417342164672553e+19,50453934963,5,13,9,9.18861471861472,2.1552570346320348,6,18,11,35,48
2015-09-07,3.3325482538918363e+19,74964832858,5,18,25,8.913614718614719,3.9066955266955263,6,33,13,52,70
2015-09-08,2.270041101074889e+20,510369578242,17,91,114,63.56926046176046,17.763766233766233,27,248,79,354,445
2015-09-09,3.137399306570769e+20,705041730835,24,108,191,80.37931096681096,26.381693722943723,19,353,117,489,597
2015-09-10,1.617694793637043e+20,363355262897,18,82,93,54.842725468975466,12.435050505050505,29,160,63,252,334
2015-09-11,2.4408082425762126e+20,547950693479,12,73,92,70.26444805194805,16.172925685425685,24,263,93,380,453
2015-09-12,5.847704702328295e+19,131225997113,9,33,62,15.50434704184704,5.485768398268397,3,57,31,91,124
2015-09-13,3.215194053757262e+19,72107368684,2,27,16,12.234027176527176,5.973831168831168,2,27,21,50,77
2015-09-14,9.200752713017411e+19,206239705192,14,67,148,32.021814574314575,8.223008658008657,17,91,35,143,210
2015-09-15,1.3712296600012916e+20,307214512217,11,62,281,38.481194083694085,7.038917748917749,26,144,43,213,275
2015-09-16,1.3526828611374701e+20,302905817144,12,99,286,39.79491161616161,9.140324675324674,15,140,55,210,309
2015-09-17,3.809051171243876e+20,852516326525,47,188,221,123.40339802789802,31.430434343434342,36,377,178,591,779
2015-09-18,3.127503320954559e+20,699650452265,17,78,87,100.31483585858585,27.089812409812406,38,304,143,485,563
2015-09-19,1.9678830341414407e+20,440012654811,9,65,125,57.17896464646464,19.95338023088023,7,222,76,305,370
2015-09-20,1.1103274847473887e+20,248151885684,13,117,87,31.24366792929293,8.555186688311688,10,119,43,172,289
2015-09-21,1.6730185342257857e+20,373696128476,20,54,96,67.0151028138528,17.514532828282828,25,141,93,259,313
2015-09-22,1.8355186567607383e+20,409791307658,28,121,138,68.12810966810967,25.40356782106782,30,159,95,284,405
2015-09-23,2.5412525054703983e+20,567100325997,21,65,60,69.44049783549784,21.187270923520924,24,275,94,393,458
2015-09-24,2.0770113555779253e+20,463235836320,17,97,93,68.61927789802789,13.604381313131313,33,205,83,321,418
2015-09-25,2.887255742835251e+20,643657939644,23,106,85,69.72283730158729,16.38078373015873,35,307,104,446,552
2015-09-26,1.4055980820092617e+20,313189259136,5,15,44,36.5247619047619,6.981515151515151,10,164,43,217,232
2015-09-27,2.1517812398986117e+20,479195673996,5,21,41,48.15588023088023,5.833946608946609,9,287,36,332,353
2015-09-28,2.846847169495269e+20,633672679371,32,157,161,88.9586544011544,26.50657647907648,41,281,117,439,596
2015-09-29,3.05601655229062e+20,679902385237,17,100,102,75.55143338143338,28.20301587301587,25,340,106,471,571
2015-09-30,1.6944391764774417e+20,376784506337,30,137,93,48.73653318903319,15.222602813852813,19,179,63,261,398
2015-10-01,2.215142720160588e+20,492305844168,28,52,93,57.18702380952381,19.86952380952381,23,232,86,341,393
2015-10-02,2.671158673600987e+20,593396559926,34,214,217,73.45632756132756,15.897261904761905,24,302,85,411,625
2015-10-03,5.917377205025959e+19,131392109294,7,35,62,22.92563492063492,1.088921356421356,13,56,22,91,126
2015-10-04,4.944928083527175e+19,109741085309,7,62,31,11.676937229437229,4.522521645021644,3,57,16,76,138
2015-10-05,2.2460110340708454e+20,498197142023,9,103,88,65.56811724386723,22.400048340548338,14,234,97,345,448
2015-10-06,1.6805943829839466e+20,372587915813,21,137,86,56.5712518037518,16.02652958152958,28,151,79,258,395
2015-10-07,2.8676385480760626e+20,635457219433,26,122,80,85.90826479076479,17.86824134199134,30,306,104,440,562
2015-10-08,3.7169899482981964e+20,823255881471,51,197,188,122.45390542328042,30.751474266474265,55,374,141,570,767
2015-10-09,2.551048290396143e+20,564756205755,25,66,363,70.18492424242424,19.85712121212121,23,281,87,391,457
2015-10-10,5.6792727574209724e+19,125669084168,4,22,84,22.377621753246753,6.242340367965368,3,56,28,87,109
2015-10-11,3.1352403139751506e+19,69339074168,5,18,39,13.03745670995671,5.371453823953823,4,24,20,48,66
2015-10-12,2.0587657645977043e+20,455067817685,19,109,141,65.8138979076479,24.438310786435785,16,208,91,315,424
2015-10-13,1.5104828289797318e+20,333733596012,20,39,82,55.195228475228475,27.28974025974026,11,130,90,231,270
2015-10-14,3.958502686418504e+20,874123217961,67,186,190,137.3623202260702,21.02554292929293,61,405,139,605,791
2015-10-15,4.189693509894328e+20,924744460807,41,129,140,131.23055014430014,33.10363997113997,50,419,171,640,769
2015-10-16,2.8033659921026925e+20,618458822597,30,174,194,87.03777056277056,18.203158369408367,35,287,106,428,602
2015-10-17,6.35699265678683e+19,140173244055,22,64,70,21.604415584415584,7.483766233766233,8,58,31,97,161
2015-10-18,1.409970448064407e+20,310715834522,15,105,129,43.88729437229437,10.488210678210677,9,159,47,215,320
2015-10-19,2.388263211487131e+20,526076562736,78,168,272,109.23536297498798,18.859907587782587,52,194,118,364,532
2015-10-20,2.5864207943576217e+20,569466056885,64,159,200,89.33227212602212,23.295786435786432,42,236,116,394,553
2015-10-21,2.3513949175982745e+20,517464544270,50,92,134,68.70400102212602,17.00455898268398,30,246,82,358,450
2015-10-22,8.018463800802939e+20,1763553743083,317,1211,1390,332.05897456709954,95.74670093795093,134,678,408,1220,2431
2015-10-23,8.705888744688134e+20,1913982068222,292,689,1343,320.5275390812891,121.6240818903319,95,790,439,1324,2013
2015-10-24,2.1907243188299556e+20,481412984306,33,91,187,54.34521645021645,21.334238816738818,9,249,75,333,424
2015-10-25,1.777214246033366e+20,390357532550,14,46,102,29.375420274170274,7.74387987012987,10,229,31,270,316
2015-10-26,2.2987129139742035e+20,504608992661,33,124,132,89.80013347763348,30.839161255411256,31,200,118,349,473
2015-10-27,2.800802348914388e+20,614531195652,55,135,151,76.58846981721982,27.23093253968254,23,294,108,425,560
2015-10-28,3.9034035936013556e+20,856054698548,40,87,94,81.11284632034632,32.214092712842714,26,448,118,592,679
2015-10-29,3.10735363968411e+20,681126356785,61,103,463,93.47296176046176,25.681439393939392,34,314,123,471,574
2015-10-30,2.666725579621478e+20,584269021916,34,209,197,69.82910543160543,24.657104978354976,21,294,89,404,613
2015-10-31,1.0170275817210593e+20,222728413119,6,32,17,35.896136363636366,6.900238095238095,18,88,48,154,186
2015-11-01,7.334802070225189e+19,160548213006,10,35,59,22.66917869167869,7.629507575757575,11,68,32,111,146
2015-11-02,1.976912862754466e+20,432494932857,43,265,268,69.14834776334776,12.790288600288601,37,182,80,299,564
2015-11-03,2.3947065690747227e+20,523652514393,32,149,237,82.96625901875902,31.915910894660893,25,201,136,362,511
2015-11-04,3.23011411485766e+20,705963389146,87,244,422,126.34037698412698,34.604089105339106,62,253,173,488,732
2015-11-05,2.5696245719973822e+20,561332593901,71,409,466,94.00584535834535,23.65874098124098,54,218,116,388,797
2015-11-06,2.4053307393064727e+20,525194649329,64,253,356,88.94200396825397,22.634556277056276,37,218,108,363,616
2015-11-07,1.120380029485503e+20,244525052101,18,81,139,26.839437229437227,14.105557359307358,6,117,46,169,250
2015-11-08,5.6388050339268215e+19,122994931640,12,69,93,15.441926406926406,5.795411255411255,6,59,20,85,154
2015-11-09,2.1305720563018528e+20,464512822942,28,76,114,72.48641594516594,15.952959956709956,29,214,78,321,397
2015-11-10,2.2976297394967685e+20,500716662828,26,103,103,92.64228835978835,30.727510822510823,28,184,134,346,449
2015-11-11,4.0797507391665334e+20,888613511563,82,253,350,161.661079004329,49.06894264069264,68,333,213,614,867
2015-11-12,3.004902136594091e+20,654195858092,58,160,271,116.73149711399711,34.12042388167388,44,251,157,452,612
2015-11-13,2.7072223673640082e+20,589101045497,89,124,190,91.64808802308802,27.745382395382396,42,252,113,407,531
2015-11-14,9.648965985371034e+19,209885998857,13,15,28,22.425030663780664,5.42399531024531,14,105,26,145,160
2015-11-15,3.862089882955413e+19,83960368325,14,26,57,19.793589466089465,6.771507936507936,10,22,26,58,84
2015-11-16,3.2980701992157603e+20,716605433287,102,221,304,108.3828354978355,39.0880294011544,39,312,144,495,716
2015-11-17,2.506389532675288e+20,544358933390,57,121,170,92.42953643578643,23.998863636363634,37,221,118,376,497
2015-11-18,3.1281406047479e+20,679044286710,100,227,346,106.5638455988456,23.710007215007213,65,269,135,469,696
2015-11-19,2.522502670051202e+20,547320770463,37,148,204,83.02421837421838,25.532088744588744,38,240,100,378,526
2015-11-20,2.5706474867919752e+20,557490477162,35,130,165,77.05896103896104,22.528151154401154,33,259,93,385,515
2015-11-21,9.151548887216312e+19,198389384284,19,45,86,31.15212662337662,12.985698051948052,8,91,38,137,182
2015-11-22,8.822932026658824e+19,191161725759,10,47,55,28.068706108706106,7.860324675324675,7,90,35,132,179
2015-11-23,2.394297200998858e+20,518487414407,49,210,393,86.3939448051948,21.793328523328523,37,213,108,358,568
2015-11-24,3.031284889307268e+20,656113706905,52,156,276,119.86789862914863,31.505594937469937,71,229,153,453,609
2015-11-25,2.7450377104960736e+20,593869138462,74,128,210,91.09537698412699,27.186152597402597,46,256,108,410,538
2015-11-26,1.460277939415225e+20,315781763502,30,82,104,54.458690476190476,16.938116883116884,21,128,69,218,300
2015-11-27,1.9906257073648642e+20,430244202588,19,107,120,75.08815416065416,22.410829725829725,36,168,93,297,404
2015-11-28,1.0527745672338945e+20,227447192585,24,91,134,31.474011544011542,7.648733766233766,16,102,39,157,248
2015-11-29,1.1339185714438359e+20,244847836091,21,67,55,48.5649531024531,7.691760461760461,17,105,47,169,236
2015-11-30,3.591591315214194e+20,775156920975,86,391,394,149.71535533910534,45.226848845598845,74,260,201,535,926
2015-12-01,3.526329353001649e+20,760712604814,46,202,264,133.65919528619528,42.43630014430014,74,284,167,525,727
2015-12-02,3.151886100893338e+20,679610423440,95,168,278,128.94850769600768,29.591661255411253,68,239,162,469,637
2015-12-03,2.8509751189449294e+20,614438572729,40,100,142,118.37500721500722,28.515576298701298,57,241,126,424,524
2015-12-04,1.8702931928746616e+20,402887387378,31,119,208,81.56753878066378,24.431036255411254,31,150,97,278,397
2015-12-05,8.548192633135614e+19,184062521133,12,28,74,31.285317460317458,7.73517316017316,12,81,34,127,155
2015-12-06,7.27346179674731e+19,156535461477,7,108,105,21.949848484848484,7.391060606060606,3,78,27,108,216
2015-12-07,2.1092423773945017e+20,453693603968,24,94,129,76.33031385281384,26.18296717171717,31,188,94,313,407
2015-12-08,2.6497020877631868e+20,569685965521,46,97,185,91.86894841269842,35.37402236652237,35,222,136,393,490
2015-12-09,2.2935743338653814e+20,492886964586,59,158,218,92.92116161616161,17.084646464646465,50,187,103,340,498
2015-12-10,2.139530372283847e+20,459571065934,37,1026,335,79.77320526695526,19.74353986291486,45,179,93,317,1343
2015-12-11,3.0186745965419305e+20,648080044261,40,117,207,91.69287548100048,32.06493957431457,40,297,110,447,564
2015-12-12,1.0134367102657844e+20,217487460168,14,25,83,35.89357142857143,12.49567821067821,15,89,46,150,175
2015-12-13,1.1019314334191426e+20,236352193448,14,27,75,35.1413455988456,7.973463203463203,23,101,39,163,190
2015-12-14,1.9818734118568906e+20,424880191716,22,82,149,68.71304473304473,17.89821608946609,32,175,86,293,375
2015-12-15,2.4024804912869668e+20,514816014329,23,121,166,89.62463985088985,29.09280844155844,32,209,114,355,476
2015-12-16,1.7334781132751808e+20,371271092246,31,89,171,68.62878787878788,18.699648268398267,26,143,87,256,345
2015-12-17,2.391468187201883e+20,511975790598,44,112,163,87.32292748917749,21.092983405483405,41,214,98,353,465
2015-12-18,3.185822936798342e+20,681708375635,39,161,187,103.21974386724386,23.15319624819625,43,294,133,470,631
2015-12-19,8.68016834072406e+19,185666010712,14,33,51,29.35253427128427,9.136661255411255,7,83,38,128,161
2015-12-20,7.328734157952667e+19,156667241056,8,59,71,17.995277777777776,4.382247474747475,11,75,22,108,167
2015-12-21,2.2676458250938184e+20,484535770925,26,182,191,77.873877002627,20.13926046176046,40,205,89,334,516
2015-12-22,1.9631393565636834e+20,419278197132,27,136,506,65.34054713804714,22.082366522366524,22,189,78,289,425
2015-12-23,2.6302642516725986e+20,561489521557,49,158,212,94.2425937950938,30.75268217893218,41,228,118,387,545
2015-12-24,2.0128054233834753e+20,429484173255,42,72,250,81.55970057720057,0.00182539682539571,62,165,69,296,368
2015-12-25,7.823853692211593e+19,166869542830,8,54,59,18.940248917748917,5.833181818181818,7,83,25,115,169
2015-12-26,7.623937085361344e+19,162526399581,11,54,86,24.081576479076478,4.847770562770563,12,73,27,112,166
2015-12-27,8.9221901413508e+19,190109540576,4,33,35,26.176298701298702,10.523683261183262,3,97,31,131,164
2015-12-28,3.700467862675128e+20,788063419948,76,287,343,142.9618308080808,58.605968915343915,48,295,200,543,830
2015-12-29,5.182006919819086e+20,1103063253027,144,593,770,214.5355096200096,75.31401479076479,80,399,281,760,1353
2015-12-30,2.8582923042573576e+20,608168853158,31,199,232,115.43462481962482,43.379886363636366,46,229,144,419,618
2015-12-31,2.8394673467404147e+20,603853526258,34,237,259,95.3417821067821,31.473474025974024,27,276,113,416,653
2016-01-01,9.287138010693956e+19,197423818973,13,25,88,32.00123015873016,9.17329274891775,16,76,44,136,161
2016-01-02,1.0385687671283166e+20,220664325045,15,52,99,35.23248196248196,11.913784271284271,10,101,41,152,204
2016-01-03,1.544986409443358e+20,328112050602,37,123,189,41.39834235209235,14.89915404040404,14,161,51,226,349
2016-01-04,4.576143216152527e+20,971334354044,79,403,790,181.15853607503607,54.707700396825395,93,349,227,669,1072
2016-01-05,3.633917777200836e+20,771010722586,51,183,306,126.40423354423355,31.725943362193362,64,327,140,531,714
2016-01-06,3.478451445550838e+20,737660911979,51,213,264,130.68825316944958,37.542382781900635,68,280,160,508,721
2016-01-07,3.51451293300025e+20,744964859715,66,251,288,123.35159932659933,25.5740873015873,66,317,130,513,764
2016-01-08,3.1534667303816516e+19,66804859382,10,26,27,10.333015873015873,2.8028246753246755,8,22,16,46,72
2016-01-09,8.77802379163467e+19,185899316290,12,93,97,37.01976190476191,11.343030303030302,18,62,48,128,221
2016-01-10,7.8221979954666e+19,165576760370,7,37,55,26.01688311688312,6.522862554112553,16,65,33,114,151
2016-01-11,2.341214293713179e+20,495311624714,28,77,129,80.28234487734488,23.46484126984127,43,193,105,341,418
2016-01-12,2.438529854417908e+20,515675498121,25,69,146,85.06999777999778,12.346434745809745,44,219,92,355,424
2016-01-13,4.17879090918418e+20,883241803385,93,333,526,150.3057160894661,28.52248556998557,79,371,158,608,941
2016-01-14,3.7338209631436315e+20,788858619828,72,220,264,142.81447907647907,32.0214237012987,73,304,166,543,763
2016-01-15,3.563781642282288e+20,752583692153,60,185,273,106.38052609427609,25.023335137085137,70,325,123,518,703
2016-01-16,1.2871186439393262e+20,271699439981,17,41,95,37.42305194805195,10.20308170995671,15,118,54,187,228
2016-01-17,9.09081500345906e+19,191800408546,15,33,78,27.048190235690235,13.440151515151515,6,81,45,132,165
2016-01-18,1.4469911994459839e+20,305154303154,17,76,273,48.41669191919192,14.171565656565656,16,131,63,210,286
2016-01-19,2.5303328665310862e+20,533330272188,21,83,176,81.73026875901876,23.937152477152477,26,239,102,367,450
2016-01-20,3.228321561812501e+20,680143951870,47,101,187,99.12310966810966,25.776186868686867,50,313,105,468,569
2016-01-21,2.367273085746436e+20,498510584694,35,108,138,89.51097582972582,31.12725078162578,27,205,111,343,451
2016-01-22,2.1890484600969563e+20,460751669150,56,97,155,83.52132756132757,28.479787157287156,29,181,107,317,414
2016-01-23,7.115718979846742e+19,149715198417,10,27,50,26.307620851370853,10.571185064935065,12,56,35,103,130
2016-01-24,6.0831974563963716e+19,127920950668,19,185,202,19.288401875901876,5.5909451659451666,15,48,25,88,273
2016-01-25,2.157833946954516e+20,453563282293,38,174,238,71.67085894660894,20.475762626262625,32,192,88,312,486
2016-01-26,2.7609677452733438e+20,580071755357,81,142,251,90.03775733525734,25.263222703222702,43,255,101,399,541
2016-01-27,2.9425288463154967e+20,617910218667,65,141,260,104.43193692881192,29.815177669552668,45,240,140,425,566
2016-01-28,1.5151085231072642e+21,3179912109771,601,1366,2116,615.655742026492,158.95983653846153,317,1178,692,2187,3553
2016-01-29,1.0984716782810177e+21,2304699490760,246,484,813,387.4378032093568,75.76773595716453,213,934,438,1585,2069
2016-01-30,2.3851313680653455e+20,500225194281,15,65,83,54.49631313131313,12.611463744588745,25,253,66,344,409
2016-01-31,1.671914884196824e+20,350470785876,9,51,68,37.00374278499278,8.240386002886002,14,181,46,241,292
2016-02-01,2.346228122945174e+20,491564658796,36,144,197,93.14037518037517,20.742002164502164,31,206,101,338,482
2016-02-02,2.7781994300082274e+20,581771425719,74,297,392,98.71578643578643,29.734954906204905,36,236,128,400,697
2016-02-03,4.2249116112440394e+20,884341406613,114,272,359,162.66462000962,46.710458152958154,64,338,206,608,880
2016-02-04,3.364927670303276e+20,704022254893,46,135,247,100.344898989899,24.231176046176046,67,288,129,484,619
2016-02-05,4.041647740503009e+20,845173511138,140,428,600,157.89934343434342,32.894839466089465,100,302,179,581,1009
2016-02-06,1.19696310881955e+20,250217439923,33,145,177,45.188416305916306,8.156121933621934,34,91,47,172,317
2016-02-07,8.564869765643882e+19,178946942615,5,44,70,28.60566919191919,7.880757575757576,12,76,35,123,167
2016-02-08,2.5360129972959134e+20,529599192145,59,217,351,103.8021151996152,23.154854797979798,57,199,108,364,581
2016-02-09,3.7920224530639435e+20,791535086466,40,121,186,129.79364297739298,24.214457972582974,83,323,138,544,665
2016-02-10,3.6267119980239336e+20,756661738702,61,255,312,118.45479377104377,21.551574675324673,52,338,130,520,775
2016-02-11,3.823753058157649e+20,797446942935,74,151,276,111.32662157287157,21.866340187590186,62,354,132,548,699
2016-02-12,2.3388102104693355e+20,487521297063,25,120,121,103.5415748140748,25.041998556998553,47,170,118,335,455
2016-02-13,1.6554231290226567e+20,344922251902,12,41,108,27.01634199134199,8.853679653679652,9,190,38,237,278
2016-02-14,1.006327695723031e+20,209584958215,4,19,83,32.48634199134199,11.076569264069263,9,95,40,144,163
2016-02-15,1.258618378195891e+20,261998095886,10,49,102,39.28975378787879,19.281363636363636,7,117,56,180,229
2016-02-16,2.777461696069731e+20,577887331847,38,126,225,97.64632275132276,29.21874458874459,36,248,113,397,523
2016-02-17,2.9327499376855676e+20,609944061470,36,148,223,84.07065295815296,18.833405483405482,36,294,89,419,567
2016-02-18,3.907738787992057e+20,812337668507,45,273,395,114.71559163059163,24.409552669552667,58,369,131,558,831
2016-02-19,2.9988093904448284e+20,623118556335,42,268,319,88.41522246272245,22.931455627705628,43,284,101,428,696
2016-02-20,1.2758364901402791e+20,264986277608,9,116,168,29.896187839937838,6.618910256410256,12,131,39,182,298
2016-02-21,8.416486945523088e+19,174726665488,4,40,61,24.29060606060606,8.210656565656565,7,81,32,120,160
2016-02-22,3.5440087068279846e+20,735357413974,24,118,212,158.76526685351686,54.87218759018759,37,275,193,505,623
2016-02-23,2.9067636258396317e+20,602880324653,20,101,174,94.19443482443482,33.02143217893218,28,277,109,414,515
2016-02-24,2.908306889180788e+20,602917118918,52,129,228,102.16001298701299,31.105694985569983,43,260,111,414,543
2016-02-25,2.776252727974799e+20,575280837853,21,87,162,88.70668831168831,29.957296777296776,33,243,119,395,482
2016-02-26,2.4823264670374402e+20,514142020793,141,497,391,64.97506673881674,22.848598484848484,29,227,97,353,850
2016-02-27,9.638413528566232e+19,199550160048,18,65,116,32.98095779220779,8.872207792207792,14,81,42,137,202
2016-02-28,7.250347380391605e+19,150036177546,6,26,34,21.14246753246753,3.427175324675324,9,71,23,103,129
2016-02-29,2.922898008574036e+20,604553833285,34,170,202,93.8778403078403,31.391874699374696,30,244,141,415,585
2016-03-01,2.63547086100055e+20,544858802127,31,102,245,80.33031926406926,27.37528499278499,30,223,121,374,476
2016-03-02,2.2491578962603236e+20,464762459743,48,221,291,72.32628066378066,25.77295725108225,29,181,109,319,540
2016-03-03,2.9627062966034557e+20,611947111706,26,109,191,89.56406204906204,32.14988636363636,23,258,139,420,529
2016-03-04,2.9216808425554097e+20,603235978805,31,77,129,86.26630230880231,26.565597041847038,34,257,123,414,491
2016-03-05,1.3627320056915034e+20,281235212859,12,19,44,29.451739094239095,12.767301587301587,9,134,50,193,212
2016-03-06,1.3987971380861126e+20,288539247497,8,38,66,31.378638167388168,7.5741125541125545,16,146,36,198,236
2016-03-07,2.5588845460030453e+20,527566822407,44,316,673,83.01520382395383,22.86272186147186,41,217,104,362,678
2016-03-08,2.9207027772821242e+20,601923824934,23,83,166,93.63715079365079,28.48559271284271,37,242,134,413,496
2016-03-09,3.6370007222044184e+20,749174031143,35,181,209,112.70559176934177,38.32943181818182,32,330,152,514,695
2016-03-10,2.9450137570517038e+20,606369948783,41,181,180,83.76110569985569,27.281121933621932,41,258,117,416,597
2016-03-11,5.0999283619351875e+20,1049552948757,33,191,221,69.25169372294373,29.09428391053391,24,598,98,720,911
2016-03-12,8.29053978146392e+19,170559879126,3,22,39,21.0955297017797,5.266341991341991,10,79,28,117,139
2016-03-13,5.3883507985331995e+19,110798287446,9,96,91,19.39594336219336,7.616006493506493,4,45,27,76,172
2016-03-14,2.4687353232552496e+20,507373807801,23,128,142,56.698507696007695,20.17392496392496,23,243,82,348,476
2016-03-15,3.3571456500778356e+20,689659532351,15,95,165,90.08381854256854,34.97715728715728,35,292,146,473,568
2016-03-16,2.5209199684804533e+20,517639831507,25,89,133,79.52251623376623,22.709969336219334,47,209,99,355,444
2016-03-17,4.3054793066540584e+20,883684620211,59,174,291,141.862205988456,38.21027867965368,60,369,177,606,780
2016-03-18,2.2959696725323085e+20,471033879349,30,110,173,86.28085557960559,23.741363636363637,48,179,96,323,433
2016-03-19,8.533481245596736e+19,175005601627,6,42,73,34.57331002331002,12.56300505050505,10,59,51,120,162
2016-03-20,7.542320791735545e+19,154598801323,4,38,49,32.206269841269844,14.059393939393939,8,46,52,106,144
2016-03-21,5.4820456319461065e+20,1123105083102,62,109,203,135.21717712842712,40.17457972582972,54,524,192,770,879
2016-03-22,3.240921382888744e+20,663689500349,27,199,274,104.8266056998557,31.88792983405483,42,270,143,455,654
2016-03-23,3.5205377472854163e+20,720620637975,34,216,274,103.18130519480519,27.890523809523806,39,329,126,494,710
2016-03-24,2.9733094653984e+20,608333406015,56,151,245,107.79265331890332,40.90056457431457,38,234,145,417,568
2016-03-25,1.0557762369688592e+20,215919243198,14,80,78,33.420797258297256,11.792902236652237,12,92,44,148,228
2016-03-26,8.20772437266764e+19,167784761856,14,32,43,22.93088924963925,7.6257215007215,7,76,32,115,147
2016-03-27,6.783746852061928e+19,138613035398,4,103,77,22.42137445887446,8.459821428571427,5,52,38,95,198
2016-03-28,2.4792088478461077e+20,506334681118,36,154,200,88.94755627705628,24.515814935064935,48,197,102,347,501
2016-03-29,3.18105020550048e+20,649373710508,66,170,305,113.02051587301587,39.60372925685426,53,247,145,445,615
2016-03-30,3.1611043202905466e+20,645031658624,32,154,206,113.28714105339105,29.85006673881674,54,245,143,442,596
2016-03-31,3.391759304466063e+20,691773621149,33,85,145,89.26176406926406,30.574816017316017,40,290,144,474,559
2016-04-01,2.4341182425950716e+20,496237792486,32,76,152,74.64106962481962,27.969669913419914,34,201,105,340,416
2016-04-02,6.5891564124390466e+19,134282590718,6,14,60,21.858449975949974,5.4037824675324675,6,57,29,92,106
2016-04-03,7.524476267748354e+19,153267421688,20,63,136,21.61528318903319,6.876428571428571,4,72,29,105,168
2016-04-04,3.0114206916957615e+20,613108553382,22,133,200,89.98566031191031,26.718556998557,35,265,120,420,553
2016-04-05,2.998588539765154e+20,610224941087,20,62,149,72.20486652236652,20.977411616161614,24,286,108,418,480
2016-04-06,5.124570840558015e+20,1042407461375,58,221,356,182.48701654826655,67.94434496059496,41,392,281,714,935
2016-04-07,3.3031929204494434e+20,671618344372,61,170,261,98.3419733044733,25.280023448773445,41,294,125,460,630
2016-04-08,2.600756373977975e+20,528565124579,45,150,239,77.79120851370851,29.71613997113997,20,223,119,362,512
2016-04-09,5.750145346536822e+19,116816212761,8,24,31,23.777738095238096,8.4937987012987,5,40,35,80,104
2016-04-10,9.205268479655264e+19,186917947002,18,85,135,30.566433566433567,6.692382617382616,15,77,36,128,213
2016-04-11,2.0075365309142247e+20,407448358512,48,123,180,74.10400613275613,20.41013528138528,27,154,98,279,402
2016-04-12,2.4765115464563098e+20,502403867518,40,123,120,67.92143698893699,21.562128427128425,24,231,89,344,467
2016-04-13,4.832987939098918e+20,980035679385,54,152,283,160.70466699966698,65.50261634199134,52,392,227,671,823
2016-04-14,2.9113364967733802e+20,590101000641,43,209,256,90.56950577200577,27.30017316017316,28,256,120,404,613
2016-04-15,2.4008774633826835e+20,486423425734,28,136,159,64.48079906204906,20.225527597402596,32,217,84,333,469
2016-04-16,7.934197900962084e+19,160688449057,12,112,181,30.93547077922078,9.46004329004329,7,56,47,110,222
2016-04-17,5.7014385899309924e+19,115411251833,13,82,103,22.77021103896104,7.309036796536796,4,45,30,79,161
2016-04-18,5.473371287862308e+20,1107432250944,64,336,431,182.0681180856181,57.41255952380952,71,440,247,758,1094
2016-04-19,3.2942458283888915e+20,666249689171,30,219,277,116.43727813852813,32.79443181818181,41,244,171,456,675
2016-04-20,2.2984576147699938e+20,464649021645,47,232,326,73.38352994227994,21.415297619047617,38,189,91,318,550
2016-04-21,2.9505292484251435e+20,596190768554,23,325,301,92.28821488696488,35.245755772005765,34,222,152,408,733
2016-04-22,2.481664214960351e+20,501237881726,53,200,288,91.6871203102453,26.949319985569982,31,197,115,343,543
2016-04-23,9.627184787343024e+19,194368048737,13,143,197,29.143320105820106,5.649206349206349,16,78,39,133,276
2016-04-24,6.590345237200301e+19,132996590119,18,127,205,20.176219336219336,6.689437229437229,5,58,28,91,218
2016-04-25,1.782491893226609e+20,359551322089,31,1203,366,51.57362950937951,15.604748917748918,17,164,65,246,1449
2016-04-26,2.5809067339412544e+20,520358862435,38,166,207,85.24232864357865,21.00809072871573,34,224,98,356,522
2016-04-27,3.467117848692255e+20,698725648762,51,183,222,121.7264411976912,23.45430014430014,69,272,137,478,661
2016-04-28,1.1285410894274705e+21,2273203547808,303,1352,1957,409.05311991249494,109.0012293956044,208,873,474,1555,2907
2016-04-29,8.370976344693446e+20,1685606353768,132,723,890,266.43184128371627,85.37340777278277,97,725,331,1153,1876
2016-04-30,1.394622835008883e+20,280706714507,32,313,399,48.82291305916306,24.166309523809524,9,117,66,192,505
2016-05-01,1.1773725487601559e+20,236862014822,9,109,101,37.39385101010101,12.500061327561326,13,101,48,162,271
2016-05-02,4.362832389382054e+20,877319014404,56,324,501,143.96571224146223,48.85106926406926,55,346,199,600,924
2016-05-03,2.902677009515542e+20,583450367515,40,183,229,88.6771645021645,26.322509018759018,39,258,102,399,582
2016-05-04,3.5447214952011334e+20,712175378634,44,139,292,122.00595938783438,37.15511537074037,59,266,162,487,626
2016-05-05,3.539126021797411e+20,710753137180,56,163,249,103.92662698412698,38.100492424242425,40,300,146,486,649
2016-05-06,1.122116980627106e+20,225233939635,9,56,101,34.782146464646466,9.173726551226553,19,94,41,154,210
2016-05-07,1.1662043423178292e+20,234018074086,17,53,85,21.23628108003108,8.100199106449105,10,121,29,160,213
2016-05-08,8.60546640301471e+19,172599557675,9,85,98,23.751482683982683,7.445849567099566,6,86,26,118,203
2016-05-09,2.5392814539676126e+20,509055758628,32,119,183,88.12792618492618,34.12960642135642,29,191,128,348,467
2016-05-10,7.147296515748484e+20,1432174267663,100,421,679,269.3630517676768,88.78772204184703,81,482,416,979,1400
2016-05-11,8.158499235931478e+20,1634142445695,167,752,944,265.9350156325156,75.83113275613275,92,663,362,1117,1869
2016-05-12,6.233409941272688e+20,1247992307073,130,289,521,209.60206094831094,67.36169663669664,99,466,288,853,1142
2016-05-13,6.053608121620989e+20,1211484623277,114,763,705,226.93189069264068,54.22908333333333,109,447,272,828,1591
2016-05-14,1.2653760256272241e+20,253137365933,16,82,143,39.454442099567096,11.552197510822511,13,109,51,173,255
2016-05-15,1.2295195456956155e+20,245838305965,36,125,173,41.843014069264065,12.736461038961037,13,93,62,168,293
2016-05-16,4.429796550372797e+20,885359739288,66,506,410,141.151085997336,33.99765241702741,75,344,186,605,1111
2016-05-17,4.8789954262953525e+20,974688408486,55,297,459,166.9077934102934,44.2418759018759,61,397,208,666,963
2016-05-18,4.6979994161898435e+20,938152252979,77,495,635,147.35559042809044,33.958462301587296,58,407,176,641,1136
2016-05-19,3.519742845424576e+20,702557996388,56,157,206,108.56948532948533,31.30026575276575,50,293,137,480,637
2016-05-20,2.9345854825588523e+20,585499959762,34,161,197,75.58239898989899,24.250136183261183,36,263,101,400,561
2016-05-21,1.0642925369974e+20,212255782700,14,26,57,37.22773448773449,15.041764069264069,10,82,53,145,171
2016-05-22,7.637383235793843e+19,152247777909,7,73,72,20.7045664983165,9.623484848484848,6,60,38,104,177
2016-05-23,2.2924396954431898e+20,456772533426,30,208,222,69.10821645021645,20.49812073112073,23,196,93,312,520
2016-05-24,3.337407412697653e+20,664701071579,31,120,149,92.10437981000481,35.14650432900433,36,299,119,454,574
2016-05-25,2.9271455634439674e+20,582744908327,41,195,315,92.80102092352092,32.67089646464646,36,227,135,398,593
2016-05-26,3.3406482297736515e+20,664778338687,27,69,210,99.45527236652237,28.88727813852814,52,265,137,454,523
2016-05-27,2.2748064099143238e+20,452485618218,30,166,123,70.92686174936175,18.09670274170274,43,183,83,309,475
2016-05-28,4.419170220787281e+19,87866221297,1,42,24,14.144318181818182,2.079545454545454,5,41,14,60,102
2016-05-29,4.495003812520208e+19,89335857641,6,104,92,11.703939393939395,2.4527272727272726,4,44,13,61,165
2016-05-30,1.1722950954587863e+20,232874453990,6,66,55,34.66562049062049,9.81445165945166,12,103,44,159,225
2016-05-31,2.707192645019943e+20,537546937893,32,206,256,108.05023027898028,28.496967893217892,40,186,141,367,573
2016-06-01,4.029504768594431e+20,799774776032,55,221,392,142.68214646464645,50.55857864357864,47,301,198,546,767
2016-06-02,3.7065863927993434e+20,735367063139,16,145,245,135.50347883597883,27.628195346320343,57,281,164,502,647
2016-06-03,2.6889257703434273e+20,533244916738,26,98,154,83.9884632034632,25.225574494949495,29,228,107,364,462
2016-06-04,8.277191054821347e+19,164083878410,3,59,109,22.197705627705627,7.186222943722943,8,69,35,112,171
2016-06-05,6.1373933064892195e+19,121605988774,9,105,88,20.087175324675325,6.3609956709956705,9,49,25,83,188
2016-06-06,2.1380642650229208e+20,423448731936,24,83,130,70.77336038961039,23.26332792207792,28,164,97,289,372
2016-06-07,2.6646571697614943e+20,527510968318,25,146,179,96.0875,22.415753968253966,42,205,113,360,506
2016-06-08,3.576716974275757e+20,707782870397,48,276,370,82.88414862914863,22.431435786435785,27,337,119,483,759
2016-06-09,3.5636515995977037e+20,704893697661,38,101,211,112.37388167388167,42.39247474747474,31,298,152,481,582
2016-06-10,3.2171211238798944e+20,636056523500,213,148,227,103.99152092352092,27.146076479076477,54,242,138,434,582
2016-06-11,1.0530164238474274e+20,208120434287,53,24,42,33.788170995670995,4.344025974025974,14,90,38,142,166
2016-06-12,7.790477619139173e+19,153901618332,40,45,75,22.997640692640694,6.757085137085136,9,65,31,105,150
2016-06-13,2.3013297476358796e+20,454406818842,48,63,86,77.97410894660895,27.4837987012987,32,181,97,310,373
2016-06-14,2.354369647810507e+20,464693233409,26,50,99,80.59338023088023,36.15202922077922,19,189,109,317,367
2016-06-15,3.938592249935076e+19,77698589307,5,13,24,13.413769841269842,3.426787518037518,4,31,18,53,66
2016-06-16,2.4012729950172414e+20,473544506205,40,118,189,77.53488117438117,23.464162467162467,31,192,100,323,441
2016-06-17,2.41732696316906e+20,476504932580,36,103,171,78.96984848484848,22.016533189033186,40,186,99,325,428
2016-06-18,8.48360125783696e+19,167153668630,7,38,48,25.746422558922557,7.903012265512265,11,65,38,114,152
2016-06-19,9.751954139705803e+19,192087852108,4,116,146,25.25835137085137,7.177031024531024,11,88,32,131,247
2016-06-20,1.9143649584745113e+20,376872605677,23,112,112,65.88486652236652,27.298232323232323,28,138,91,257,369
2016-06-21,2.079296931609931e+20,409159259792,30,102,156,65.1579347041847,24.641181457431458,22,165,92,279,381
2016-06-22,2.7961166576672303e+20,549977731358,22,62,99,85.03034632034633,26.141488095238092,35,214,126,375,437
2016-06-23,2.6108360568177358e+20,513339423254,26,94,122,83.22306637806638,27.019761904761904,41,202,107,350,444
2016-06-24,2.776301828040792e+20,545638804087,48,339,296,97.74613395863396,29.40885642135642,44,212,116,372,711
2016-06-25,5.749326120773747e+19,112947754650,12,28,56,16.443964646464647,7.016969696969697,2,55,20,77,105
2016-06-26,5.827015139277442e+19,114421814685,12,46,41,20.427191558441557,5.930357142857143,12,40,26,78,124
2016-06-27,2.6459193075906878e+20,519331213022,23,104,190,79.32655122655123,30.09148178210678,22,222,110,354,458
2016-06-28,3.0585149803274496e+20,600054184011,24,248,154,90.44695526695527,36.599085497835496,27,242,140,409,657
2016-06-29,3.7557291399067075e+20,736538717513,44,99,137,126.00749819624819,43.05169191919192,46,296,160,502,601
2016-06-30,3.345778016885707e+20,655878797520,25,190,268,88.36180495430496,30.708309884559885,37,294,116,447,637
2016-07-01,3.0629179002736706e+20,600159157796,38,133,146,91.70809620934621,25.5109521034521,47,248,114,409,542
2016-07-02,1.1312888494173517e+20,221586109097,5,118,67,20.878961038961037,9.75025974025974,6,118,27,151,269
2016-07-03,8.32022435195191e+19,162897642808,1,84,30,22.050183982683983,7.304047619047618,7,74,30,111,195
2016-07-04,1.3573767177396732e+20,265641513161,5,90,61,40.2489448051948,13.801406926406926,11,117,53,181,271
2016-07-05,2.213518470244845e+20,432980710221,24,83,153,67.37850468975469,16.940660173160172,32,184,79,295,378
2016-07-06,3.783515186475439e+20,739778858448,52,183,342,136.1955325230325,50.35022977022977,35,274,195,504,687
2016-07-07,3.2745417740881324e+20,640003208434,61,155,264,110.58165098790099,32.75894036519036,34,250,152,436,591
2016-07-08,3.2236513174582126e+20,629768040559,46,133,243,112.2038189033189,33.23726695526695,44,240,145,429,562
2016-07-09,9.396586718522112e+19,183507580311,6,60,76,33.64839826839827,5.0540999278499275,15,71,39,125,185
2016-07-10,7.671626288252764e+19,149751749760,13,76,96,27.092310606060604,6.706212121212121,10,57,35,102,178
2016-07-11,5.1020706943781136e+20,995472957014,79,301,546,159.45381612831613,56.97754723054723,63,395,220,678,979
2016-07-12,8.454761399693224e+20,1648938895932,158,1437,932,265.5509235209235,106.70751803751804,142,624,357,1123,2560
2016-07-13,3.306722545810091e+20,644636962738,59,259,357,87.37050144300144,34.08058080808081,34,280,125,439,698
2016-07-14,4.619332115372472e+20,900189299086,16,110,156,115.84199855699855,40.069653679653676,49,403,161,613,723
2016-07-15,2.4729913347211087e+20,481698579534,38,256,180,72.45513949013949,18.694087301587302,42,199,87,328,584
2016-07-16,7.54283716081183e+19,146867022593,10,40,51,25.023820346320345,9.47401515151515,8,52,40,100,140
2016-07-17,6.942798482085462e+19,135125739108,9,28,62,19.781020923520924,5.4026911976911975,6,59,27,92,120
2016-07-18,3.3373388982455894e+20,649233418395,37,87,200,100.09954184704185,26.9437012987013,57,274,111,442,529
2016-07-19,3.0518328340572923e+20,593450694350,36,182,222,97.85175111925112,17.726811868686866,57,228,119,404,586
2016-07-20,2.403325227837168e+20,467149260383,41,575,192,80.72880832130832,27.901437590187587,31,176,111,318,893
2016-07-21,3.289148303637189e+20,639062620260,36,163,289,85.37137205387205,25.919695165945164,33,274,128,435,598
2016-07-22,3.010804802517844e+20,584739500006,31,143,224,82.03283189033189,14.29369227994228,51,245,102,398,541
2016-07-23,1.0217310493073606e+20,198352688011,15,125,177,24.606482683982684,7.876850649350649,7,92,36,135,260
2016-07-24,1.393244632483828e+20,270363175801,27,96,146,33.3047113997114,20.321103896103896,17,106,61,184,280
2016-07-25,2.4923995822373362e+20,483450143198,22,219,255,56.27573051948052,15.144823833573833,22,234,73,329,548
2016-07-26,3.979144401708457e+20,771508556863,11,113,155,82.68400913900913,24.140651154401155,43,372,110,525,638
2016-07-27,2.7753979527873606e+20,537884244181,24,72,143,77.12364205239204,27.38332251082251,30,226,110,366,438
2016-07-28,1.0857287084645136e+21,2103180743996,246,891,1584,359.48407925407923,94.23467234154734,173,807,451,1431,2322
2016-07-29,8.364120606803726e+20,1619712316571,85,839,881,242.03715127465128,73.1950024050024,109,650,343,1102,1941
2016-07-30,1.4882648198312473e+20,288094653300,16,140,184,39.50381673881674,13.693387445887446,13,129,54,196,336
2016-07-31,1.1395801416206284e+20,220494953938,9,151,176,25.783421717171716,10.03469696969697,8,101,41,150,301
2016-08-01,3.8310182349538886e+20,740911419384,13,329,343,100.07202056277056,34.040610209235204,24,346,134,504,833
2016-08-02,2.098868660446782e+20,405759381239,16,81,167,57.80459415584416,11.868142135642135,30,179,67,276,357
2016-08-03,2.6401471735744948e+20,510171749800,34,129,229,73.21178932178933,21.130028860028858,30,228,89,347,476
2016-08-04,3.265447174425165e+20,630764531452,65,190,396,89.5585137085137,27.529103535353535,41,272,116,429,619
2016-08-05,3.5792278415096755e+20,691087879480,22,239,340,89.83720779220779,30.978268398268398,39,294,137,470,709
2016-08-06,1.1199469793263285e+20,216160357942,11,107,118,25.901060606060604,10.090146103896103,10,95,42,147,254
2016-08-07,1.1662412653457297e+20,224997109582,12,166,233,29.582184343434342,10.04228354978355,9,104,40,153,319
2016-08-08,4.2479806291359564e+20,819160831169,32,273,498,121.4684571909572,52.851470658970655,29,362,166,557,830
2016-08-09,2.952776673680197e+20,569178816895,35,97,244,95.73926587301587,34.44726911976912,38,220,129,387,484
2016-08-10,2.1450698567325188e+20,413305078470,23,45,115,68.701727994228,15.203349567099567,43,160,78,281,326
2016-08-11,2.986202856480572e+20,575131099097,27,93,143,72.9264466089466,22.674316979316977,32,259,100,391,484
2016-08-12,2.055364588396308e+20,395700318521,15,71,92,60.79988528138528,21.536792207792207,18,170,81,269,340
2016-08-13,1.0778201371415285e+20,207422965919,9,51,84,27.25530303030303,5.4892045454545455,17,96,28,141,192
2016-08-14,1.5143035382082008e+20,291293134672,5,80,114,37.541825396825395,13.812539682539681,18,129,51,198,278
2016-08-15,2.7393457027894503e+20,526714011758,38,101,163,79.2187536075036,36.99345779220779,21,215,122,358,459
2016-08-16,2.1588205766021395e+20,414921756152,15,100,121,66.24283405483405,22.447138888888887,19,178,85,282,382
2016-08-17,2.8798514290082447e+20,553262958858,28,89,115,87.45737012987013,24.638012265512263,25,229,122,376,465
2016-08-18,2.9041767916292555e+20,557709425622,12,78,109,94.38200577200577,21.360975829725827,46,224,109,379,457
2016-08-19,2.951544077944527e+20,566571759581,14,86,139,83.75944083694084,27.098946608946605,32,221,132,385,471
2016-08-20,1.027717876278212e+20,197206590111,10,133,273,22.260454545454543,6.695858585858586,9,94,31,134,267
2016-08-21,1.0589551604787372e+20,203106684903,5,34,30,38.53117965367965,10.702072510822509,18,72,48,138,172
2016-08-22,2.049818875819332e+20,392990428467,13,78,127,57.67353715728716,18.65305916305916,31,156,80,267,345
2016-08-23,3.2412163403009366e+20,621164978522,37,117,194,86.72916486291486,35.22007305194805,37,254,131,422,539
2016-08-24,2.20536576769612e+20,422475654862,18,44,96,61.450088383838384,13.78366341991342,38,174,75,287,331
2016-08-25,2.921490155741023e+20,559411043359,15,80,145,77.94800625300626,22.329963924963923,33,236,111,380,460
2016-08-26,3.00747702982238e+20,575638314908,10,287,144,99.86328823953824,33.01997294372294,33,223,135,391,678
2016-08-27,1.1619059025453282e+20,222316076530,7,48,86,33.09122294372294,13.26012085137085,14,88,49,151,199
2016-08-28,1.0547659403348053e+20,201717971135,10,70,84,40.25719877344877,11.94146645021645,14,82,41,137,207
2016-08-29,3.088766720743921e+20,590464761912,27,96,172,107.30768975468975,33.180589466089465,45,224,132,401,497
2016-08-30,2.8898457526909698e+20,552212407127,15,115,132,76.42201298701299,25.81592893217893,25,238,112,375,490
2016-08-31,2.952875434654087e+20,564025831646,10,69,88,83.61188311688312,32.03710678210678,28,243,112,383,452
2016-09-01,3.285889417352635e+20,627385407581,34,98,172,93.45569985569985,33.21714165464165,35,272,119,426,524
2016-09-02,2.3768793133924608e+20,453630390889,16,71,100,80.81488816738816,13.111045274170273,47,172,89,308,379
2016-09-03,9.804592374788045e+19,187058011554,4,42,60,24.60021645021645,6.794886363636364,14,78,35,127,169
2016-09-04,7.569511959398452e+19,144352950323,8,64,119,22.536287878787878,7.624507575757575,6,63,29,98,162
2016-09-05,1.2828239778606377e+20,244531512718,26,73,121,44.941767676767675,10.141637806637805,19,93,54,166,239
2016-09-06,3.8659208481753e+20,736588222642,47,179,316,133.5969852092352,47.86963455988456,48,247,205,500,679
2016-09-07,3.944907990144177e+20,751359772583,33,186,248,101.47938672438673,28.18994949494949,39,327,144,510,696
2016-09-08,2.801488453046116e+20,533350950291,14,42,70,80.13458513708514,24.583413299663295,21,223,118,362,404
2016-09-09,3.259527880664072e+20,620312724709,26,65,132,99.6658712121212,38.81135912698412,32,235,154,421,486
2016-09-10,1.6498408980336738e+20,313857121751,13,66,81,51.30391774891775,12.361369047619046,15,128,70,213,279
2016-09-11,1.0306988813741718e+20,195988827842,11,64,138,26.97334776334776,7.033532647907647,11,78,44,133,197
2016-09-12,3.147807011512259e+20,598316567007,24,89,234,83.06418410293409,29.893254870129866,23,253,130,406,495
2016-09-13,3.4905955597027115e+20,663198021723,33,107,146,91.96524531024531,33.56843073593073,28,276,146,450,557
2016-09-14,3.7251193663162476e+20,707454554222,36,92,146,105.82472342472342,34.49546356421356,34,289,157,480,572
2016-09-15,3.951935134008469e+20,750238477773,33,157,240,107.72147186147185,30.52034812409812,43,312,154,509,666
2016-09-16,3.65861636110784e+20,694269484253,32,175,382,108.26027994227994,39.975721139971135,38,287,146,471,646
2016-09-17,1.072409011218435e+20,203427449699,8,92,102,25.11935064935065,7.637900432900432,9,92,37,138,230
2016-09-18,1.0107449694716535e+20,191646584588,6,46,65,28.32848124098124,5.846933621933621,14,81,35,130,176
2016-09-19,2.9013996634439116e+20,549910203875,25,64,170,80.31591089466089,29.117219516594517,29,232,112,373,437
2016-09-20,2.2723943115351455e+20,430517914746,22,78,138,69.92531866281867,19.576109307359307,27,177,88,292,370
2016-09-21,3.176704784527481e+20,601583213548,43,325,548,105.34788808413808,32.32752344877345,41,234,133,408,733
2016-09-22,3.965132497491734e+20,750553127440,44,152,323,133.86318759018758,44.07477236652237,36,294,179,509,661
2016-09-23,3.569245949745561e+20,675383872941,36,108,192,119.16377705627706,21.36670815295815,57,253,148,458,566
2016-09-24,1.2396622850780828e+20,234480612941,7,29,59,29.15067821067821,9.9111544011544,9,98,52,159,188
2016-09-25,9.906328294272365e+19,187300568875,10,52,76,22.4717316017316,9.036525974025974,9,82,36,127,179
2016-09-26,2.8406626990103442e+20,536862607042,22,78,128,81.29205988455989,32.81386002886003,33,225,106,364,442
2016-09-27,3.9897839362320735e+20,753718533502,62,398,506,137.57666065416066,47.27993506493506,42,273,196,511,909
2016-09-28,5.8585451143225967e+20,1106304830786,103,305,520,193.75057208994707,59.85588834776335,81,391,278,750,1055
2016-09-29,3.805804810006987e+20,718400089934,49,131,242,123.27562950937951,29.76712121212121,59,275,153,487,618
2016-09-30,4.4252735293689646e+20,834987338065,59,231,375,153.79979677729676,45.48354978354978,71,298,197,566,797
2016-10-01,1.9084929486277686e+20,359977751395,15,63,146,55.69694805194805,19.862007575757573,22,149,73,244,307
2016-10-02,1.267746777618587e+20,239016704352,15,89,173,40.25122072372072,14.609381174381173,11,101,50,162,251
2016-10-03,4.008660604306705e+20,755457423299,44,97,242,122.98643939393939,49.05400252525252,38,304,170,512,609
2016-10-04,4.151545374901892e+20,782063091244,46,92,209,127.89057012432012,50.67003066378066,36,300,194,530,622
2016-10-05,4.9371732114240484e+20,929677415908,65,275,471,168.91082972582973,53.51687049062049,55,357,218,630,905
2016-10-06,4.610018291324779e+20,867746365865,52,162,365,129.59768879268879,46.50002344877345,54,349,185,588,750
2016-10-07,2.9884784587951905e+20,562297003918,20,143,221,90.55142857142857,19.779343434343435,51,215,115,381,524
2016-10-08,1.0593641999666289e+20,199249932240,7,23,49,27.771493506493506,8.908647186147187,13,86,36,135,158
2016-10-09,9.499715551438771e+19,178598118705,7,31,97,27.821103896103896,12.155465367965368,8,73,40,121,152
2016-10-10,2.5606786976767957e+20,481211539241,12,81,155,92.03430916305916,22.68032828282828,38,192,96,326,407
2016-10-11,3.6070808670603425e+20,677574762632,48,270,417,113.96291522366522,36.66866847041847,38,265,156,459,729
2016-10-12,6.045888612207442e+20,1135259312353,65,278,339,174.7398953823954,52.61656565656565,53,470,246,769,1047
2016-10-13,4.7272362115211493e+20,887295913540,39,177,234,116.74202922077922,31.486706349206347,42,402,157,601,778
2016-10-14,3.7535112091918126e+20,704264963570,29,151,256,98.35474206349207,24.67534812409812,54,289,134,477,628
2016-10-15,1.6138617104666768e+20,302688631297,8,60,74,44.62327200577201,21.403154761904762,8,132,65,205,265
2016-10-16,1.1342081525195538e+20,212633865890,13,52,117,27.132489177489177,8.845919913419912,9,97,38,144,196
2016-10-17,4.310469671297086e+20,807762336303,44,241,324,117.82341644466645,39.401681096681095,57,330,160,547,788
2016-10-18,3.760492083688254e+20,704431400604,51,116,320,104.2863492063492,30.824806998556998,32,306,139,477,593
2016-10-19,3.4861680610542774e+20,652781782146,38,142,207,112.0572637085137,28.344888167388167,55,251,136,442,584
2016-10-20,3.7877292205863213e+20,708947289468,39,154,239,142.74484884559885,31.937589826839826,56,257,167,480,634
2016-10-21,3.0078312408881955e+20,562758410212,27,64,157,96.66541486291486,31.90732142857143,44,214,123,381,445
2016-10-22,1.3900332897493184e+20,259975931639,30,219,342,43.09488636363636,12.062486471861472,19,105,52,176,395
2016-10-23,1.6040612095868777e+20,299877299198,21,219,340,42.0518105043105,8.666347402597403,26,131,46,203,422
2016-10-24,4.4271595468537305e+20,827299294377,56,304,474,129.98001082251082,44.64871663059163,57,334,169,560,864
2016-10-25,4.4607190307184666e+20,833254754720,48,167,278,140.5857178932179,37.19984848484848,72,316,176,564,731
2016-10-26,3.6557005069479025e+20,682600450102,35,161,277,104.40969800041228,20.894427437641724,59,285,118,462,623
2016-10-27,1.242971775225356e+21,2319818473948,303,1125,1776,380.4142472943723,93.95383561808562,188,954,428,1570,2695
2016-10-28,1.0129402586710916e+21,1889923709148,123,443,1449,311.754066017316,73.70914345839346,143,770,366,1279,1722
2016-10-29,1.7906080767413925e+20,333968127499,19,140,359,57.91797258297258,14.177540584415583,23,136,67,226,366
2016-10-30,1.8786911047989612e+20,350245375257,26,199,290,53.842922077922076,14.027388167388166,21,142,74,237,436
2016-10-31,3.981304543821876e+20,741916854255,39,223,336,121.6947113997114,29.967023508898507,62,289,151,502,725
2016-11-01,4.2369849334141996e+20,789255468951,33,192,290,131.20426046176047,31.358437950937954,106,284,144,534,726
2016-11-02,4.175512010767482e+20,777479160463,46,168,382,132.1195936933437,35.840800865800865,70,301,155,526,694
2016-11-03,3.359408914152037e+20,625271744067,27,138,231,88.64597222222223,29.144085497835498,42,258,123,423,561
2016-11-04,3.1463393429819707e+20,585393225312,31,105,193,100.9938455988456,27.760052308802308,53,220,123,396,501
2016-11-05,1.0174148626978275e+20,189227937289,9,68,102,24.862132034632033,3.572220418470419,15,85,28,128,196
2016-11-06,8.509125084621665e+19,158192677350,3,43,61,18.74135101010101,5.0970959595959595,12,70,25,107,150
2016-11-07,3.110945425585343e+20,578105193694,21,89,168,94.73197691197691,38.12029581529581,31,225,135,391,480
2016-11-08,2.3640848964474172e+20,439148163512,18,135,211,68.94455988455988,26.33833152958153,28,179,90,297,432
2016-11-09,2.994271007456154e+20,555990934192,39,170,232,80.67484307359307,22.529161255411257,46,230,100,376,546
2016-11-10,5.680802720132604e+20,1054380227842,141,334,659,188.91243807118806,49.99307088744589,102,389,222,713,1047
2016-11-11,3.6824028072112954e+20,683237082550,33,151,314,110.43374458874459,31.480781625781624,64,261,137,462,613
2016-11-12,1.0765053820598668e+20,199658609871,6,30,59,27.281453823953825,9.899264069264069,9,86,40,135,165
2016-11-13,1.2445563470725023e+20,230730791561,26,228,158,38.75673881673882,11.334260461760461,25,86,45,156,384
2016-11-14,5.595317949431762e+20,1036876092404,89,423,552,158.87815295815295,46.52623256373256,83,431,187,701,1124
2016-11-15,4.6953469702632374e+20,869780760098,50,250,240,127.97278198653198,41.332642496392495,66,351,171,588,838
2016-11-16,3.850621937675406e+20,713024438649,44,110,182,110.34309042809042,34.08347582972583,59,281,142,482,592
2016-11-17,4.851558189817541e+20,897992990327,36,330,399,140.45912698412698,57.60441919191919,62,350,195,607,937
2016-11-18,4.765721056595259e+20,881769288873,24,174,247,135.38692563388992,55.499773757988045,45,350,201,596,770
2016-11-19,1.7278712193516156e+20,319584014521,8,96,126,44.44179292929293,15.75239898989899,25,141,50,216,312
2016-11-20,1.6806882022530613e+20,310726073880,13,73,138,45.29841991341991,13.723225108225108,22,136,52,210,283
2016-11-21,5.4930360339028725e+20,1015104976895,50,328,540,214.33006373256373,56.66032768157768,74,403,209,686,1014
2016-11-22,5.7195112630684575e+20,1056591946381,53,211,366,236.5301893939394,54.953191738816734,83,393,238,714,925
2016-11-23,3.814719824714061e+20,704435455727,16,1057,221,123.93088413900914,24.78227362914863,67,286,123,476,1533
2016-11-24,2.4533476834237664e+20,452875868961,9,167,311,57.121852453102456,18.23132215007215,37,206,63,306,473
2016-11-25,3.7380036460685695e+20,689718049754,30,192,287,109.95579725829725,17.040971320346323,100,261,105,466,658
2016-11-26,1.5568231450590085e+20,287151541200,16,23,57,33.06497474747475,13.192113997113998,21,129,44,194,217
2016-11-27,1.5896481462093952e+20,293089490110,19,187,256,30.179772727272727,11.461515151515153,14,149,35,198,385
2016-11-28,5.381819991283171e+20,991832020209,49,1175,488,152.76567616642618,56.47909235209235,75,407,188,670,1845
2016-11-29,4.982336745027325e+20,917865848713,42,311,396,151.00950757575757,49.57041305916306,69,370,181,620,931
2016-11-30,4.68718042761741e+20,863141879691,47,168,243,146.3010227272727,30.475818001443,83,326,174,583,751
2016-12-01,5.5819820661820706e+20,1027536295361,53,237,394,161.13525613275613,51.39002585377585,68,425,201,694,931
2016-12-02,3.9992771886292835e+20,735901180631,38,204,307,119.79095598845599,44.72311568061568,36,293,168,497,701
2016-12-03,1.1592145076192849e+20,213230063855,6,31,57,37.803369408369406,11.154296536796537,11,88,45,144,175
2016-12-04,1.562505107937429e+20,287287009752,18,114,189,43.14290524290524,10.435050505050505,26,121,47,194,308
2016-12-05,6.269157406358623e+20,1152181969998,60,377,468,168.87056637806637,54.84502615440115,46,482,250,778,1155
2016-12-06,5.715394704434958e+20,1050049625116,65,252,353,194.56372474747474,75.05652958152957,43,380,286,709,961
2016-12-07,4.096986803424905e+20,752407944109,20,153,251,111.1429341029341,38.127965367965366,46,301,161,508,661
2016-12-08,4.2682934937613304e+20,783557748323,32,192,330,119.29689009139008,37.508641414141415,52,319,158,529,721
2016-12-09,3.2933909018429476e+20,604365227383,28,198,277,93.78387265512265,26.773757215007212,45,240,123,408,606
2016-12-10,1.397115683166119e+20,256278284130,11,251,117,38.58563852813853,16.42337121212121,14,108,51,173,424
2016-12-11,1.0907084131014923e+20,199997236513,6,31,55,32.759736652236654,6.11924062049062,20,74,41,135,166
2016-12-12,3.152397353194616e+20,577804649707,28,406,231,110.32037337662338,38.85896825396825,37,208,145,390,796
2016-12-13,3.897853048664234e+20,714150516076,35,129,287,116.52387218337218,37.463840728715724,45,280,157,482,611
2016-12-14,7.079174474508456e+20,1296511274333,62,370,440,194.3242839105339,87.65679022366523,57,484,334,875,1245
2016-12-15,5.131474195010739e+20,939465252251,38,285,361,145.172948024198,54.872049963924965,53,359,222,634,919
2016-12-16,3.660085660796246e+20,669816650574,26,143,201,106.20445346320346,37.84369769119769,47,264,141,452,595
2016-12-17,1.7092523493323004e+20,312695931189,12,92,96,46.83660353535353,17.274074675324677,12,142,57,211,303
2016-12-18,1.0941383565195094e+20,200079012742,11,126,81,35.256477272727274,7.560173160173161,20,78,37,135,261
2016-12-19,2.8785186113316907e+20,526165647553,29,155,252,86.19934704184703,34.76267045454546,30,208,117,355,510
2016-12-20,3.342185180656309e+20,610683913535,45,133,227,96.50696188071188,24.63260642135642,55,241,116,412,545
2016-12-21,3.116456568415785e+20,569214744751,44,163,299,90.63311688311688,28.497853535353535,33,236,115,384,547
2016-12-22,3.3452447555533485e+20,610756859493,37,168,200,74.09233525733525,26.751891233766234,30,278,104,412,580
2016-12-23,2.4693959556278646e+20,450680819644,43,115,209,67.09003787878788,22.761242784992785,32,186,86,304,419
2016-12-24,1.0238719648587992e+20,186804216650,31,45,146,32.6479834054834,13.578252164502164,8,70,48,126,171
2016-12-25,1.3090597631218144e+20,238712847707,9,46,95,37.34735209235209,8.897328643578643,14,99,48,161,207
2016-12-26,1.4152400325118573e+20,257999237270,11,23,79,39.721481851481855,11.393717532467532,29,94,51,174,197
2016-12-27,3.784050094212083e+20,689527047657,39,194,323,111.11052308802309,67.31149621212121,54,242,169,465,659
2016-12-28,4.420590199729433e+20,805232474394,51,237,365,123.56365019240019,67.62980339105339,44,313,186,543,780
2016-12-29,5.2125203945559785e+20,949130554042,58,359,448,154.86716089466088,63.18784451659452,69,369,202,640,999
2016-12-30,4.522305004370803e+20,823123564003,49,372,424,125.11189033189034,45.24533008658008,50,331,174,555,927
2016-12-31,1.4428109429795727e+20,262523083909,12,70,109,45.10896103896104,11.892752525252524,14,110,53,177,247
2017-01-01,1.2885695864472106e+20,234357818895,15,76,104,32.78415945165945,13.706298701298701,11,103,44,158,234
2017-01-02,1.8602410154780918e+20,338205976077,10,63,84,48.677032828282826,17.385151515151513,19,137,72,228,291
2017-01-03,4.5549396045795394e+20,827768138433,70,901,1277,144.28139887889887,39.149621212121204,50,321,187,558,1459
2017-01-04,5.1203524261157955e+20,930178243774,58,262,404,130.5408207070707,35.36641233766233,69,390,168,627,889
2017-01-05,9.028003012698606e+20,1639407011473,115,426,870,264.0359262080512,83.00549177211677,129,616,360,1105,1531
2017-01-06,6.195609815937557e+20,1124651759311,76,283,509,178.72864177489177,53.5978382034632,75,463,220,758,1041
2017-01-07,2.224171661088257e+20,403591497688,23,163,210,59.771601731601734,17.11005411255411,27,170,75,272,435
2017-01-08,1.8815470726018184e+20,341291622019,21,130,181,54.4978373015873,18.36353354978355,22,135,73,230,360
2017-01-09,4.215029986998951e+20,764244157718,32,210,365,117.77217893217893,36.38887806637806,53,320,142,515,725
2017-01-10,3.340723672735137e+20,605493728572,30,106,223,93.50914682539683,37.8418759018759,24,253,131,408,514
2017-01-11,4.194267988245993e+20,759882648181,56,196,383,105.68457371332372,33.68121663059163,42,327,143,512,708
2017-01-12,8.548069555207022e+20,1548056737798,219,1331,951,244.7319191919192,81.93295544733044,86,605,352,1043,2374
2017-01-13,5.550611499130746e+20,1004878168187,68,206,425,175.33723665223664,48.92259289321789,65,381,231,677,883
2017-01-14,1.533829599531241e+20,277581487542,19,130,241,44.40138528138528,14.915714285714285,13,119,55,187,317
2017-01-15,2.125413244293728e+20,384482058868,6,72,135,60.67444444444445,16.74956349206349,30,151,78,259,331
2017-01-16,2.0770478781980996e+20,375595928856,12,79,161,53.84312770562771,16.186805555555555,14,168,71,253,332
2017-01-17,2.9815087951209556e+20,538931804667,16,130,206,83.2417316017316,28.75310064935065,33,218,112,363,493
2017-01-18,3.689549853727522e+20,666652626753,35,204,342,103.60055735930736,27.947191558441556,59,247,143,449,653
2017-01-19,3.707562210561878e+20,669659744756,59,225,371,122.61409632034632,39.70347763347763,41,262,148,451,676
2017-01-20,3.108765616722155e+20,561298368341,30,115,189,87.0997126022126,41.59669552669553,28,220,130,378,493
2017-01-21,1.9581928151902116e+20,353429678707,13,67,89,58.15656926406926,23.082130230880228,13,143,82,238,305
2017-01-22,1.4158612451375663e+20,255436378181,2,65,89,53.232175324675325,11.541390692640693,25,93,54,172,237
2017-01-23,4.150606920330618e+20,748531007414,51,224,372,108.01280122655122,37.24289862914863,45,300,159,504,728
2017-01-24,4.358380925830822e+20,785705600086,54,179,364,115.16569264069264,52.51989538239538,44,296,189,529,708
2017-01-25,4.220228138317619e+20,760501586401,49,171,411,138.70754605579606,71.20275396825397,37,263,212,512,683
2017-01-26,3.710811797712672e+20,668448385985,32,118,259,115.65453823953824,50.55866522366522,25,250,175,450,568
2017-01-27,3.316341312979207e+20,597179397976,49,197,339,88.35747344322344,28.41490404040404,23,260,119,402,599
2017-01-28,1.58460050771264e+20,285236135188,22,71,160,48.42963564213564,12.073493867243865,17,114,61,192,263
2017-01-29,1.3624001815842515e+20,245139922280,27,124,228,37.758419913419914,13.236114718614719,13,97,55,165,289
2017-01-30,3.469506829077312e+20,624030177985,36,253,368,117.63207070707071,48.245111832611826,31,219,170,420,673
2017-01-31,4.727162626938423e+20,849917944875,52,219,312,136.47266774891776,54.94753472222222,34,326,212,572,791
2017-02-01,4.7457497832953715e+20,852938767186,48,174,346,150.88606782106783,66.54151875901876,42,290,242,574,748
2017-02-02,1.2648144352920407e+21,2272183935980,323,1143,2165,378.38456846790774,92.59738973922902,199,853,477,1529,2672
2017-02-03,1.0476096347096939e+21,1881434677834,177,746,1265,266.909329004329,61.383012265512264,154,797,315,1266,2012
2017-02-04,1.9039932625194526e+20,341826780890,12,171,191,55.57403318903319,16.398991702741704,20,136,74,230,401
2017-02-05,1.9877512067224175e+20,356712075628,28,65,133,55.632669552669554,21.257665945165943,16,148,76,240,305
2017-02-06,3.314406213213992e+20,594555591658,61,136,234,96.45087211399711,28.868366702741703,45,228,127,400,536
2017-02-07,3.780050360940328e+20,677832171820,115,159,279,90.72486291486291,28.92518217893218,35,291,130,456,615
2017-02-08,3.881221765619605e+20,695710305752,52,162,350,98.5479310966811,25.738690476190474,44,300,124,468,630
2017-02-09,3.5345144027013395e+20,633313089157,44,121,256,96.48921753246753,29.7087316017316,32,260,134,426,547
2017-02-10,3.5526240959681246e+20,636322527852,35,153,278,96.48596237096237,30.088217615717614,41,261,126,428,581
2017-02-11,9.05096955321783e+19,162062205192,23,40,71,29.289181096681098,4.271082251082251,12,66,31,109,149
2017-02-12,1.0301292103922916e+20,184375731058,26,77,110,32.68639249639249,7.131230158730158,14,69,41,124,201
2017-02-13,4.330268119253227e+20,774724658759,127,155,296,131.9191829004329,45.872534271284266,38,307,176,521,676
2017-02-14,4.082657784565323e+20,730156119101,47,159,310,104.51022943722944,23.403185064935062,43,332,116,491,650
2017-02-15,4.2592007169466165e+20,761430765066,42,106,266,113.58243686868687,38.264494949494946,33,310,169,512,618
2017-02-16,3.33720771003696e+20,596388056682,55,1010,351,96.22417027417028,36.73403679653679,26,237,138,401,1411
2017-02-17,4.004767796758546e+20,715410727342,59,199,413,132.1477489177489,53.75174873737374,37,267,177,481,680
2017-02-18,1.607523689614639e+20,287071501415,22,68,187,45.037673160173156,11.413607503607503,16,114,63,193,261
2017-02-19,1.2082807864853958e+20,215688730078,8,64,145,38.92301406926407,15.026174242424242,6,84,55,145,209
2017-02-20,2.6593625019995033e+20,474542499665,27,77,139,73.1788023088023,27.209175685425684,19,186,114,319,396
2017-02-21,4.512197947714855e+20,804838903344,77,215,538,145.88367965367965,54.02095238095238,42,289,210,541,756
2017-02-22,3.838146047448106e+20,684372620808,61,145,303,124.66707431457431,43.47468344155844,44,237,179,460,605
2017-02-23,3.2805846779307046e+20,584727378593,39,129,196,103.31904256854257,35.30965512265512,45,214,134,393,522
2017-02-24,2.881155236617359e+20,513340159845,46,98,288,84.50404761904763,18.673026695526694,50,185,110,345,443
2017-02-25,1.1947063223121609e+20,212787419684,18,82,132,31.685844155844155,7.428538961038961,14,87,42,143,225
2017-02-26,1.1200240884945471e+20,199407341709,16,60,124,32.846020923520925,11.400340007215007,16,74,44,134,194
2017-02-27,4.24799953832816e+20,756008368272,101,123,336,124.52486808561808,56.89698556998557,58,263,187,508,631
2017-02-28,5.412825454858625e+20,962928043674,216,234,524,170.09924639249638,31.618795634920634,94,366,187,647,881
2017-03-01,4.870717992852488e+20,866228921265,41,196,378,146.9851139138639,28.635949374699372,83,326,173,582,778
2017-03-02,4.1614491727699214e+20,739767662035,41,102,265,104.52821789321789,23.04724206349206,53,324,120,497,599
2017-03-03,4.7997354892459514e+20,852937051732,36,155,395,111.57139249639249,23.690512265512265,68,375,130,573,728
2017-03-04,1.6843693381850032e+20,299214324231,5,63,126,61.040009018759015,11.610369769119767,26,97,78,201,264
2017-03-05,2.0791519795209775e+20,369201919663,31,43,127,61.34304112554113,17.775757575757574,34,134,80,248,291
2017-03-06,3.2040166779252716e+20,568724670507,30,99,231,82.90161616161616,33.006852453102454,37,219,126,382,481
2017-03-07,3.6417103564336785e+20,646179519653,23,109,207,97.6330992063492,37.9804402056277,37,251,146,434,543
2017-03-08,3.928695938613889e+20,696842178247,30,216,349,110.0203823953824,36.40866883116883,44,283,141,468,684
2017-03-09,2.5195510499218722e+20,446721270381,31,128,235,73.21140331890332,24.086782106782106,30,181,89,300,428
2017-03-10,2.4785548934067015e+20,439299670961,31,105,240,81.83618506493507,28.43275432900433,31,162,102,295,400
2017-03-11,8.74136911666404e+19,154879885350,11,89,108,24.983686868686867,8.401414141414142,13,58,33,104,193
2017-03-12,6.979257019664796e+19,123613148278,17,101,106,16.995004995004994,7.748280885780885,5,51,27,83,184
2017-03-13,1.5143666268522834e+20,268095609291,42,119,215,39.544588744588744,14.63051948051948,13,112,55,180,299
2017-03-14,1.9441441731246988e+20,344072888158,44,65,191,50.819617604617605,20.822431457431456,18,137,76,231,296
2017-03-15,3.022868385328117e+20,534762554236,40,104,295,104.53345057720058,30.96395202020202,45,192,122,359,463
2017-03-16,2.7882334957301406e+20,493081043273,58,130,314,88.51048520923521,35.13294191919192,42,145,144,331,461
2017-03-17,2.7472618011808743e+20,485660027077,41,158,301,77.07072247197247,25.25384983072483,33,192,101,326,484
2017-03-18,9.526381982090625e+19,168351016646,95,61,135,30.587660533910533,13.183804112554112,12,54,47,113,174
2017-03-19,9.8684246498623e+19,174321849812,23,81,180,25.260479797979798,3.4880321067821063,14,69,34,117,198
2017-03-20,2.4303247519510423e+20,429127929978,39,144,338,90.93163961038961,30.738376623376624,29,144,115,288,432
2017-03-21,3.9676898526858084e+20,700349535551,53,1024,430,114.79028499278499,35.17347222222222,43,268,159,470,1494
2017-03-22,2.972807010693492e+20,524547153246,32,235,614,72.61018759018759,18.99565355940356,33,227,92,352,587
2017-03-23,2.1629756407166095e+20,381511111268,17,557,227,51.33536616161616,15.072768759018759,14,176,66,256,813
2017-03-24,1.9948273183980542e+20,351725443378,11,147,257,61.17280663780664,21.19614177489177,25,119,92,236,383
2017-03-25,8.456044139388207e+19,149044277699,25,254,273,27.564733044733043,9.722388167388168,10,49,41,100,354
2017-03-26,9.897849365258713e+19,174392003793,14,54,152,37.20832611832612,12.249267676767676,18,48,51,117,171
2017-03-27,2.8183528533894627e+20,496376814668,25,190,271,67.20929653679653,21.970690836940836,37,206,90,333,523
2017-03-28,4.648543086019791e+20,818400304559,59,268,474,108.80500541125541,41.50110389610389,38,339,172,549,817
2017-03-29,6.412603308102772e+20,1128536452342,119,1396,1094,209.58029286916786,67.11110173160172,81,397,279,757,2153
2017-03-30,3.7795767755094753e+20,664932530914,63,270,503,122.26832819957819,38.7312049062049,48,226,172,446,716
2017-03-31,4.9427974775416796e+20,869236265069,103,370,825,169.64747614885115,51.86430519480519,71,290,222,583,953
2017-04-01,1.0686664124857378e+20,187872199504,45,107,345,33.892276334776334,13.500075757575758,11,67,48,126,233
2017-04-02,9.758190896487996e+19,171481362104,11,59,179,35.31980519480519,11.998560606060606,9,54,52,115,174
2017-04-03,3.293738130375761e+20,578596806476,57,177,660,95.95412878787879,36.705056818181816,39,199,150,388,565
2017-04-04,5.4609571904407614e+20,958920253774,123,288,789,188.08929196729196,54.67893975468975,80,313,250,643,931
2017-04-05,9.762223342981129e+20,1713620927132,240,692,1518,302.0317402967403,85.94064033189034,126,625,398,1149,1841
2017-04-06,6.000766777920659e+20,1052986920609,104,1175,820,160.10131673881673,61.265990259740256,52,420,234,706,1881
2017-04-07,3.35039718803446e+20,587680673526,54,156,579,114.40573051948051,26.555152417027415,54,208,132,394,550
2017-04-08,1.0463350702939926e+20,183473273892,13,84,233,29.85523088023088,8.909426406926407,13,65,45,123,207
2017-04-09,1.0382999857011283e+20,181992867567,16,152,295,28.763546176046177,6.333621933621933,12,73,37,122,274
2017-04-10,4.120985695192039e+20,722048082883,55,271,485,128.37544733044732,46.84560606060606,36,274,174,484,755
2017-04-11,3.304970333485955e+20,578864603061,57,204,475,93.94643065268065,27.448094035594035,42,218,128,388,592
2017-04-12,3.758006761648206e+20,657974086836,83,245,524,135.40335567210568,51.06155182780183,41,212,188,441,686
2017-04-13,3.214079868840488e+20,562520420802,43,152,377,97.03897907647908,38.222716450216446,36,193,148,377,529
2017-04-14,1.4840014509215616e+20,259638637236,22,88,207,52.43180014430014,16.74223484848485,26,86,62,174,262
2017-04-15,9.044423487122583e+19,158180093227,23,37,116,33.01986471861472,9.752808441558441,11,47,48,106,143
2017-04-16,7.853089386636467e+19,137296041748,20,43,132,32.85712031024531,8.966638708513708,11,44,37,92,135
2017-04-17,3.85152639289562e+20,673092118346,58,274,434,99.80904581529582,37.08489718614719,40,272,139,451,725
2017-04-18,2.7424014678718562e+20,479099972838,30,183,297,82.60935064935065,23.55664862914863,38,178,105,321,504
2017-04-19,3.0940485669524767e+20,540326126949,38,1165,860,90.63182539682539,34.59327380952381,33,208,121,362,1527
2017-04-20,3.3688878312833594e+20,588121524811,52,554,692,102.51041997354497,35.31978144540644,36,227,131,394,948
2017-04-21,2.8314379290021685e+20,494111117221,42,157,355,91.94636724386724,39.13272727272727,28,171,132,331,488
2017-04-22,1.3777954226123194e+20,240351633536,59,397,613,48.720563973063975,20.12848124098124,15,78,68,161,558
2017-04-23,1.2071142944239459e+20,210505578846,35,125,264,38.865295815295816,12.343398268398268,15,78,48,141,266
2017-04-24,3.5373930033191315e+20,616626865684,46,243,516,102.5998051948052,33.19428751803752,40,242,131,413,656
2017-04-25,4.2158228431238385e+20,734619856474,63,265,523,120.32102813852813,44.50970177970178,49,267,176,492,757
2017-04-26,4.003226743267111e+20,697330296133,102,236,569,144.33483946608948,40.59809884559884,56,229,182,467,703
2017-04-27,1.180126348437082e+21,2054800971610,386,1095,2348,384.72805044492543,135.56612554112553,151,731,494,1376,2471
2017-04-28,1.0715717508282356e+21,1865237496963,257,1163,1869,315.1273035806786,113.0577885031635,127,698,424,1249,2412
2017-04-29,2.2658277870329414e+20,394273977318,50,172,305,66.46561195286195,22.59193795093795,23,143,98,264,436
2017-04-30,1.4940933142478858e+20,259879246007,26,221,184,48.720563973063975,14.681774891774891,19,89,66,174,395
2017-05-01,5.446377744427903e+20,946973137931,103,284,747,156.71392977392978,58.21469155844156,45,371,218,634,918
2017-05-02,3.231295924515124e+20,561642048579,63,159,344,89.49958846708847,28.69686799311799,28,228,120,376,535
2017-05-03,2.983409591573659e+20,518355763603,50,199,345,84.02170033670033,24.174009740259738,38,198,111,347,546
2017-05-04,2.915862394773015e+20,506434633144,53,144,362,82.54629268879269,20.807359307359306,39,204,96,339,483
2017-05-05,3.1235321630994334e+20,542317905628,53,159,455,89.15714646464646,32.62858585858586,30,219,114,363,522
2017-05-06,1.583979508681473e+20,274910649628,25,92,222,49.55738816738817,13.153073593073591,24,90,70,184,276
2017-05-07,1.2831763183869254e+20,222629718605,31,77,210,45.782945887445884,14.271852092352093,16,72,61,149,226
2017-05-08,4.471695049928248e+20,775518869586,74,762,726,128.90023393273393,28.102843314093313,61,302,156,519,1281
2017-05-09,5.887016909383445e+20,1020631708020,152,825,801,176.01263047138048,60.94651154401154,58,372,253,683,1508
2017-05-10,3.535431740764677e+20,612713600620,62,526,459,102.82705086580087,27.228804112554112,41,237,132,410,936
2017-05-11,2.950292217547511e+20,511122009015,78,254,422,101.71040584415584,31.496132756132756,41,178,123,342,596
2017-05-12,8.372081408306024e+19,144977590031,14,58,105,20.104319985569987,5.966801948051947,13,56,28,97,155
2017-05-13,1.5368178740869608e+20,266053218793,29,137,227,56.54374458874459,19.611612554112554,24,86,68,178,315
2017-05-14,1.3906224238146e+20,240657453074,33,530,656,52.36545634920635,26.673396464646466,8,83,70,161,691
2017-05-15,4.6490179359981784e+20,804234441141,135,799,1527,135.974724025974,37.1520670995671,75,285,178,538,1337
2017-05-16,4.331039279706973e+20,748966345167,101,316,643,149.97207972582973,49.497941919191916,65,243,193,501,817
2017-05-17,5.543547491288541e+20,958311690041,133,359,677,166.6325444925445,45.29814123376623,85,351,205,641,1000
2017-05-18,3.6424901162556064e+20,629443255910,71,210,452,116.19302308802308,40.21188912938913,33,233,155,421,631
2017-05-19,2.5360981010121913e+20,438093938002,34,145,397,91.03929653679654,38.49902236652237,26,148,119,293,438
2017-05-20,1.186279133327354e+20,204853489999,32,78,201,45.84184704184704,13.440963203463204,16,66,55,137,215
2017-05-21,1.1261578746474542e+20,194398242669,12,72,117,35.79580447330447,10.96862554112554,13,67,50,130,202
2017-05-22,2.8079589967104043e+20,484529491049,47,307,483,91.82680555555555,18.949518398268395,30,180,114,324,631
2017-05-23,3.4507182352284117e+20,595227853574,60,200,400,107.87776334776335,41.57584415584415,34,213,151,398,598
2017-05-24,3.8338313216874316e+20,661070720206,92,309,560,128.37823948273947,50.885822011322006,41,206,195,442,751
2017-05-25,8.825156380993567e+20,1521153293195,341,634,1645,270.25190546953047,101.53190863303362,97,526,394,1017,1651
2017-05-26,4.297019762355229e+20,740422246810,91,251,473,122.09038961038961,35.899987373737375,57,277,161,495,746
2017-05-27,1.0681837992957256e+20,183994188186,31,192,248,31.474414474414473,11.267965367965367,14,68,41,123,315
2017-05-28,8.775005558978612e+19,151093575960,18,107,194,27.533676046176048,7.75479797979798,13,51,37,101,208
2017-05-29,1.0429954742757086e+20,179527146797,9,455,134,31.78858225108225,6.638459595959596,15,68,37,120,575
2017-05-30,5.216027646974362e+18,8976607745,0,2,1,1.442857142857143,0.6142857142857142,0,4,2,6,8
2017-05-31,4.488685952841102e+20,772057459358,77,529,1050,147.96194264069263,43.65337842712842,66,260,190,516,1045
2017-06-01,2.8805650315330506e+20,495282398634,80,306,640,83.32029401154401,19.334137806637806,35,186,110,331,637
2017-06-02,3.5696533220911435e+20,613529506696,64,280,531,116.23953222703223,35.862804834054835,51,204,155,410,690
2017-06-03,1.2019374696382985e+20,206515648803,19,50,91,38.740211038961036,6.315497835497835,21,70,47,138,188
2017-06-04,1.202507134129574e+20,206529230663,22,103,157,29.83311147186147,7.573430735930735,9,91,38,138,241
2017-06-05,4.4110099606723625e+20,757317169658,91,612,873,117.95340668590669,35.6997095959596,44,312,150,506,1118
2017-06-06,5.1802442403933605e+20,889074621761,106,393,679,141.29907557720057,47.362141053391056,64,333,197,594,987
2017-06-07,3.8038793851134765e+20,652623600536,74,367,400,105.40863368113368,25.188899017649018,51,251,134,436,803
2017-06-08,3.473789028030428e+20,595777904133,56,189,372,111.19284181096681,23.92522276334776,54,228,116,398,587
2017-06-09,6.26095298395609e+20,1073367427894,208,634,1043,210.32128547378548,37.66498196248196,117,371,229,717,1351
2017-06-10,2.043999485184301e+20,350320129251,65,140,303,71.5675091020091,18.884436776186774,25,131,78,234,374
2017-06-11,1.5817421132480027e+20,270990801045,37,162,253,46.53364898989899,13.346058802308802,22,106,53,181,343
2017-06-12,6.268520342689557e+20,1073547847803,113,441,864,173.04618482443482,48.93221284271284,80,420,217,717,1158
2017-06-13,3.95319147694758e+20,676804837801,57,359,389,112.74664351851851,34.288902417027415,59,245,148,452,811
2017-06-14,2.7299608627722512e+20,467203850926,67,99,275,83.46574915824915,30.2840854978355,34,177,101,312,411
2017-06-15,4.499352833941293e+20,769734107669,100,406,818,126.40936988936988,32.48911435786435,63,291,160,514,920
2017-06-16,3.6386823363184144e+21,6222638790050,1679,6007,12061,1340.0801893661894,410.0957607022607,478,1729,1948,4155,10162
2017-06-17,5.5539350775398216e+20,949537504569,212,713,1325,173.53018494468495,61.51405717893218,64,302,268,634,1347
2017-06-18,3.400478570743986e+20,581141696894,81,323,709,109.86672438672439,48.88162518037518,25,182,181,388,711
2017-06-19,1.0811130589325136e+21,1846890962486,312,1398,2219,321.89974025974027,101.69417568542568,127,649,457,1233,2631
2017-06-20,7.701404966815656e+20,1315212910248,260,578,1831,249.6880919080919,79.95368686868686,84,452,342,878,1456
2017-06-21,7.12554872995849e+20,1216420319364,129,489,848,221.80732744107743,68.48819624819625,87,399,326,812,1301
2017-06-22,5.416529543989324e+20,924351306796,116,363,675,166.08094215969217,48.9749522005772,80,309,228,617,980
2017-06-23,5.5241469238446195e+20,942383124771,142,295,1319,181.44501984126984,50.015032467532464,77,326,226,629,924
2017-06-24,2.187672708990478e+20,373078090450,43,140,263,89.30068362193363,30.44514971139971,32,105,112,249,389
2017-06-25,2.3907375969118414e+20,407562739056,24,213,241,98.4130284992785,44.3652398989899,19,112,141,272,485
2017-06-26,3.2009809659317486e+20,545453263940,65,189,364,106.65077922077921,34.313243145743144,51,183,130,364,553
2017-06-27,5.339771104780005e+20,909632893268,120,234,1523,200.71766293891295,61.919390331890334,80,285,242,607,841
2017-06-28,6.081207017981182e+20,1035572240788,145,372,758,202.81227392977394,71.40536345598845,79,376,236,691,1063
2017-06-29,5.678749427615459e+20,966690495294,70,219,503,197.0911075036075,72.84570526695526,73,326,246,645,864
2017-06-30,4.562339466422395e+20,776391165913,71,259,486,184.88149741462243,70.04275523088023,39,245,234,518,777
2017-07-01,2.1499174872621534e+20,365733760944,33,307,384,108.50725468975469,40.733943001443,23,84,137,244,551
2017-07-02,2.062711936096197e+20,350766268842,19,97,185,92.35612165612166,42.35743497243497,10,96,128,234,331
2017-07-03,3.756749143626555e+20,638611578284,55,253,466,148.68775974025974,59.9322095959596,34,192,200,426,679
2017-07-04,4.604756097183346e+20,782557797082,240,503,1217,168.68934704184704,57.35513708513709,55,272,195,522,1025
2017-07-05,3.9805539887321835e+20,676168375939,69,250,502,133.88887626262627,54.844493145743144,37,224,190,451,701
2017-07-06,4.635520461893225e+20,787157781628,118,287,682,143.99661227661227,32.54375652125652,80,272,173,525,812
2017-07-07,4.054455606184895e+20,688241007608,89,436,944,149.48958152958153,44.13064634439634,57,204,198,459,895
2017-07-08,2.120776676265337e+20,359883649967,37,71,197,80.91690476190476,34.37248917748918,30,99,111,240,311
2017-07-09,2.1924436975237874e+20,371903004700,40,163,274,82.08997294372294,33.907898629148626,13,131,104,248,411
2017-07-10,6.447430773343225e+20,1093279424551,195,873,1615,207.93530636030636,76.36616723554224,69,368,292,729,1602
2017-07-11,6.848109448411308e+20,1160829922432,248,450,1616,222.52001325063824,98.43660492285493,70,382,322,774,1224
2017-07-12,5.797652236311251e+20,982413708895,142,401,819,193.90064680689682,63.847743275243275,73,329,253,655,1056
2017-07-13,4.746201326037026e+20,803973803777,86,267,531,166.10347055722056,67.46223124098124,48,268,220,536,803
2017-07-14,4.6773224360145374e+20,792020923280,624,377,912,162.92772907647907,51.11484397546897,56,254,218,528,905
2017-07-15,2.6408418382962236e+20,447035398169,51,138,377,93.23310245310245,29.373847402597402,35,139,124,298,436
2017-07-16,1.9238273076700214e+20,325544806707,26,86,207,72.26939861064861,19.009499528249528,21,106,90,217,303
2017-07-17,5.86283927935224e+20,991700898962,131,482,1020,161.3551431901432,48.941120731120726,70,390,201,661,1143
2017-07-18,6.51286880459083e+20,1101283763651,211,430,1026,215.66030242905242,54.98482683982684,106,354,274,734,1164
2017-07-19,4.456019180967646e+20,753234933182,118,434,958,138.80936697561697,45.754247835497836,41,269,192,502,936
2017-07-20,6.607135124600763e+20,1116419597611,174,497,1011,189.28327777777778,53.924691197691196,78,404,262,744,1241
2017-07-21,5.365816377066281e+20,906387356021,117,436,1093,161.43832702020202,66.23209385521885,62,328,214,604,1040
2017-07-22,1.4663891217641341e+20,247619211819,34,255,392,44.692142857142855,22.007261904761904,6,93,66,165,420
2017-07-23,1.6893132773490613e+20,285155012205,82,304,712,53.991373015873016,19.689493386243385,19,96,75,190,494
2017-07-24,5.443760083472918e+20,918556358586,121,441,830,163.74724146224145,46.16213203463203,68,344,200,612,1053
2017-07-25,4.911921557603692e+20,828546241567,76,158,835,151.37234728234728,43.62978685666186,69,305,178,552,710
2017-07-26,5.225573191514834e+20,881133503351,89,309,622,168.44453851703852,54.98980609668109,68,282,237,587,896
2017-07-27,1.4757864699614918e+21,2487454465393,740,2267,4230,459.30940836940835,104.09056246993747,246,867,544,1657,3924
2017-07-28,8.686841800818021e+20,1463724547705,201,583,1660,266.6213523051023,47.8678887085137,150,541,284,975,1558
2017-07-29,1.711226679122553e+20,288255138379,20,76,192,58.536964285714284,17.35958152958153,26,95,71,192,268
2017-07-30,1.890288190767637e+20,318300996977,54,157,366,46.85693362193362,18.95351911976912,10,129,73,212,369
2017-07-31,5.476991500062628e+20,921926327243,109,251,687,136.05321608946608,33.11170544733044,79,343,192,614,865
2017-08-01,4.79207731502635e+20,806356407557,99,295,640,137.5492235079735,34.269245337995336,66,306,165,537,832
2017-08-02,4.597654267474311e+20,773366631444,94,288,543,146.20757024457023,37.62180429292929,66,266,183,515,803
2017-08-03,4.179707264575037e+20,702826754607,102,257,608,122.59759879009879,32.563098706848706,50,254,164,468,725
2017-08-04,2.8054373272178822e+20,471581020017,57,101,290,81.3052417027417,27.459549963924964,26,183,105,314,415
2017-08-05,1.0368261584485866e+20,174224718946,15,37,102,31.701940836940835,12.312074314574314,9,63,44,116,153
2017-08-06,1.1892451208205576e+20,199768864756,24,91,156,34.04092833092833,9.909597763347763,12,77,44,133,224
2017-08-07,3.2561922709809044e+20,546769604042,30,121,248,102.95470093795093,34.81510064935065,44,184,136,364,485
2017-08-08,3.9644612746641873e+20,665474015952,56,172,357,126.99391835016834,33.110453643578644,53,243,147,443,615
2017-08-09,4.091465171588673e+20,686545714452,68,183,412,134.81835016835018,42.67046897546897,49,238,170,457,640
2017-08-10,4.702222452137457e+20,788748080994,96,200,554,141.08450008325008,28.68800165112665,79,275,171,525,725
2017-08-11,4.53371314762108e+20,760242641609,64,282,545,156.81851255226255,33.996491286491285,77,244,185,506,788
2017-08-12,1.1203791584734744e+20,187816292468,19,71,110,32.52934072871573,6.820008116883116,22,63,40,125,196
2017-08-13,1.3719623725255164e+20,229901882994,27,209,258,33.3751948051948,13.224415584415585,12,92,49,153,362
2017-08-14,3.956227281198636e+20,662700032307,54,761,406,124.18421356421356,44.14818181818182,39,226,176,441,1202
2017-08-15,4.630903043558269e+20,775448179015,141,1278,992,162.28965127465128,40.8681737012987,59,268,189,516,1794
2017-08-16,6.967030134541006e+20,1166242882474,233,609,1258,240.72672077922078,75.21653318903319,101,403,272,776,1385
2017-08-17,5.65860454479769e+20,946877679256,100,227,531,178.5575653050653,46.01795454545454,82,342,206,630,857
2017-08-18,3.881598705515046e+20,649321233631,63,849,410,117.75754088504088,35.72056457431457,43,244,145,432,1281
2017-08-19,1.3393124718459906e+20,223968108796,22,46,81,49.41724206349206,16.10611652236652,13,69,67,149,195
2017-08-20,1.3938378664151264e+20,233001105362,20,126,188,39.62353896103896,10.75974025974026,16,94,45,155,281
2017-08-21,3.7425220610866276e+20,625384028450,80,321,1130,113.37275432900432,31.48311147186147,52,224,140,416,737
2017-08-22,3.3659616640032316e+20,562275060058,56,168,352,120.98858946608946,35.4562956950457,49,180,145,374,542
2017-08-23,3.916681112344046e+20,654024168321,73,282,496,118.21987313612314,40.309747474747475,40,222,173,435,717
2017-08-24,8.367939568856558e+20,1396834917197,254,623,1160,270.9076917989418,78.5262055074555,108,450,371,929,1552
2017-08-25,6.253387400558203e+20,1043543845925,147,378,842,211.83046245421247,64.29555735930735,83,313,298,694,1072
2017-08-26,1.5324177795541346e+20,255637632574,33,88,215,47.872979797979795,13.256655844155844,15,91,64,170,258
2017-08-27,1.5600595561250223e+20,260163168798,33,334,419,44.16258838383838,15.2830284992785,13,97,63,173,507
2017-08-28,5.467238633888264e+20,911383121009,125,298,712,193.27672827172827,50.55461129148629,95,233,278,606,904
2017-08-29,1.6607798088608245e+20,276741711465,22,98,219,48.234454434454435,17.005483405483403,20,90,74,184,282
2017-08-30,7.502885998761392e+20,1249904605436,85,2171,568,216.1957714045214,82.25320256132756,71,408,352,831,3002
2017-08-31,4.173056435756976e+20,694935176650,97,185,509,129.31820797258297,46.79421987734487,52,237,173,462,647
2017-09-01,3.4607979234391504e+20,576135647442,74,659,478,108.3429322991823,41.692855339105336,32,200,151,383,1042
2017-09-02,1.211292644363773e+20,201583353653,15,85,213,41.65462481962482,16.92397186147186,7,64,63,134,219
2017-09-03,1.1846580315123266e+20,197081830072,22,214,99,42.205826118326115,14.90588474025974,11,60,60,131,345
2017-09-04,6.875978587405182e+19,114345068483,17,43,153,22.106006493506495,7.737337662337661,6,38,32,76,119
2017-09-05,2.525124042310566e+20,419788606411,27,174,270,78.93316988566988,26.2903373015873,22,155,102,279,453
2017-09-06,3.042245760565503e+20,505581342468,43,134,317,87.13953896103897,23.41416474266474,36,190,110,336,470
2017-09-07,5.4438542282292724e+20,904381418470,158,246,510,160.5320386095386,50.35301677489177,47,329,225,601,847
2017-09-08,5.4460367192511716e+20,904433453093,82,1068,371,141.9551948051948,37.90344336219336,58,362,181,601,1669
2017-09-09,7.496628888348222e+20,1244600084391,25,254,314,169.35856782106782,53.5425487012987,52,520,255,827,1081
2017-09-10,6.00313177472162e+20,996334567680,21,51,103,135.02987914862913,36.64755591630591,55,427,180,662,713
2017-09-11,5.0533751301397257e+20,838362932437,56,2132,532,149.69883417508416,52.799825036075035,44,283,230,557,2689
2017-09-12,5.899445122840275e+20,978396465563,64,202,444,171.52285547785547,52.532637858173565,68,331,251,650,852
2017-09-13,7.617967105748895e+20,1262959032630,160,219,792,225.38919588744588,74.02542352092351,84,433,322,839,1058
2017-09-14,6.648893837462886e+20,1101949183220,127,183,493,203.58444985569986,60.05257846320346,80,371,281,732,915
2017-09-15,5.570196868635472e+20,922859681431,70,60,396,150.7205345117845,49.75030363155363,49,348,216,613,673
2017-09-16,2.3180163205725114e+20,383918734151,16,50,101,59.66048881673882,22.53698593073593,16,152,87,255,305
2017-09-17,2.2280514229969564e+20,368885454114,20,104,216,51.579040404040406,18.5537518037518,16,149,80,245,349
2017-09-18,6.70520187702352e+20,1109735846366,121,175,569,184.2356782106782,62.95549422799422,85,399,253,737,912
2017-09-19,6.798677203440005e+20,1124852821535,175,327,668,195.17578042328043,71.96232683982683,70,405,272,747,1074
2017-09-20,5.0260671894413856e+20,831267685506,101,195,396,159.67076219151218,52.88698376623376,67,277,208,552,747
2017-09-21,3.7527580564211014e+20,620472733712,80,161,434,121.56984247234247,41.47416486291486,30,211,171,412,573
2017-09-22,4.009492086782811e+20,662681129252,106,220,572,121.874329004329,43.55156836219336,43,238,159,440,660
2017-09-23,1.768456598144964e+20,292197275913,67,145,292,60.038809523809526,25.461839826839824,16,94,84,194,339
2017-09-24,1.5229046179149906e+20,251544316191,39,65,143,47.17271645021645,15.341875901875902,17,92,58,167,232
2017-09-25,5.4101075031318076e+20,893266154048,173,379,1007,164.41134950697452,36.21069053631553,91,309,193,593,972
2017-09-26,7.666971897302496e+19,126541623288,25,49,138,20.71475108225108,7.64663961038961,11,44,29,84,133
2017-09-27,5.0582874614241565e+20,834613546614,85,1320,607,162.2866859066859,53.87204184704184,51,275,228,554,1874
2017-09-28,4.292957593582778e+20,708104522807,72,258,385,137.9862487974988,41.8065367965368,67,226,177,470,728
2017-09-29,4.1118606077547656e+20,678010134721,72,211,641,128.72855893114823,50.29368609565038,35,225,190,450,661
2017-09-30,1.3254170065793766e+20,218481475197,16,52,101,42.121980519480516,19.9616341991342,11,68,66,145,197
2017-10-01,1.2802707055122989e+20,210960928631,13,41,60,38.72397186147186,19.189989177489178,7,79,54,140,181
2017-10-02,3.375844115750032e+20,556066501199,48,122,279,94.6327362914863,35.173983585858586,35,206,128,369,491
2017-10-03,4.814074406682142e+20,792703674372,110,388,783,163.49376563251562,55.72738335738335,55,249,222,526,914
2017-10-04,4.980730267008293e+20,819876089249,91,162,545,154.39021645021646,48.960253126503126,70,271,203,544,706
2017-10-05,6.127683124954842e+20,1008325948102,129,330,712,188.75374232249231,52.392443528693526,77,353,239,669,999
2017-10-06,6.496643542793675e+20,1068676048917,187,693,1434,225.0712269119769,76.27756908369408,72,350,287,709,1402
2017-10-07,1.750738629732664e+20,287908341718,36,85,141,61.81415404040404,19.36011183261183,24,92,75,191,276
2017-10-08,1.7698185157961e+20,290940911596,24,73,119,62.18083603896104,26.43623647186147,15,93,85,193,266
2017-10-09,3.724730551429781e+20,612071496062,55,212,535,118.14294011544011,37.491120129870126,48,200,158,406,618
2017-10-10,4.7723447491918286e+20,783975751977,108,229,491,144.4112003968254,51.18136093073593,42,311,167,520,749
2017-10-11,5.3434391842694e+20,877499472738,101,317,562,156.39439754689755,58.09473124098124,51,315,216,582,899
2017-10-12,5.887503993634568e+20,966512252098,159,217,739,189.67977693602694,64.2960082972583,60,328,253,641,858
2017-10-13,5.3842867030275955e+20,883628693364,132,229,600,162.7601491008991,57.801074259074255,58,301,227,586,815
2017-10-14,1.893512864002532e+20,310644869337,29,160,233,58.117438672438674,23.57889971139971,14,115,77,206,366
2017-10-15,1.4988469609734793e+20,245815397062,19,100,249,44.70476911976912,17.0550974025974,10,91,62,163,263
2017-10-16,3.780939270516707e+20,619855791235,72,153,469,112.7777426046176,36.75412067099567,36,237,138,411,564
2017-10-17,4.288527032412253e+20,702843550106,72,195,393,138.1055414862915,51.26398502886003,44,247,175,466,661
2017-10-18,1.841007470157489e+19,30166003334,2,5,11,5.929166666666667,1.5875,3,11,6,20,25
2017-10-19,4.595874586711879e+20,752702840973,116,339,703,143.3979816017316,47.09142135642136,62,255,182,499,838
2017-10-20,3.934208019691127e+20,644131362554,55,146,372,130.02742424242425,42.604238816738814,51,220,156,427,573
2017-10-21,1.889507837861711e+20,309260547095,23,302,360,56.57550505050505,23.57683261183261,13,114,78,205,507
2017-10-22,1.8165263378379178e+20,297209852748,28,264,219,58.54568542568543,20.594664502164502,18,108,71,197,461
2017-10-23,5.599436445402143e+20,915823797419,115,408,708,157.91613275613275,51.727824675324676,71,341,195,607,1015
2017-10-24,5.684508941194448e+20,929451598540,112,350,645,143.52721408221407,48.10899711399711,55,354,207,616,966
2017-10-25,5.363750764111338e+20,876694903578,168,978,714,207.0317988955489,41.80140137640137,81,285,215,581,1559
2017-10-26,7.204215008474053e+19,117705315045,15,28,69,25.71330808080808,10.475472582972582,9,36,33,78,106
2017-10-27,1.7665628437741872e+21,2885433873700,528,2199,3527,559.9505462962962,185.01498361360862,223,980,709,1912,4111
2017-10-28,3.891029176758269e+20,635368888871,144,377,963,125.01875541125541,47.9132205988456,38,211,172,421,798
2017-10-29,3.041972462406116e+20,496552981709,46,174,425,88.1820183982684,44.62163870851371,15,181,133,329,503
2017-10-30,5.337204979725455e+20,870906662849,90,288,724,169.48750025900026,63.474711279461275,51,312,214,577,865
2017-10-31,3.7661654693654764e+20,614348216466,54,140,372,126.49692587967589,40.96334482184482,48,205,154,407,547
2017-11-01,4.230538287153771e+20,689861475916,112,261,764,121.06120805120806,37.50429022366522,56,252,149,457,718
2017-11-02,4.528526133032949e+20,738208778961,116,185,529,137.2499237012987,42.416936568061566,49,252,188,489,674
2017-11-03,4.4006709051698224e+20,717116783154,107,331,803,138.15190656565656,49.879177489177486,39,258,178,475,806
2017-11-04,1.714563434515828e+20,279312848001,25,107,198,53.5423828948829,23.490331289081286,21,85,79,185,292
2017-11-05,1.6688731364307934e+20,271779331541,57,161,430,44.91479196729197,15.002265512265511,18,106,56,180,341
2017-11-06,3.6730615805794825e+20,597951262060,117,341,899,105.85469047619047,36.27036724386724,36,223,137,396,737
2017-11-07,3.887822179312848e+20,632714758146,59,163,403,118.05569444444444,41.822009379509375,36,210,173,419,582
2017-11-08,3.935877998086953e+20,640304673030,85,160,497,129.0208738021238,48.75919448606948,37,201,186,424,584
2017-11-09,4.4945489500159954e+20,730954524926,69,174,403,115.76793831168831,39.22340367965368,50,265,169,484,658
2017-11-10,4.041024400083433e+20,656988743315,68,193,409,112.35200757575757,30.550616883116884,57,246,132,435,628
2017-11-11,9.665767290057323e+19,157083822346,14,54,109,40.96705026455027,19.109166666666667,7,40,57,104,158
2017-11-12,1.896560641357549e+20,308139864054,37,206,282,67.6429852092352,24.933340548340546,10,110,84,204,410
2017-11-13,4.445840717966074e+20,722060220326,65,268,430,140.90371087246086,45.5207224025974,42,243,193,478,746
2017-11-14,4.3265015956261116e+20,702460099273,64,319,553,141.70407624782624,45.163674866799866,60,234,171,465,784
2017-11-15,5.100810780876366e+20,827894371707,68,350,472,168.91234066859067,67.70670003607503,51,275,222,548,898
2017-11-16,2.2256488194778268e+20,361095161726,30,98,222,60.20081168831169,19.4263474025974,19,142,78,239,337
2017-11-17,5.0207975144788584e+20,814387192009,59,233,544,162.1806125025768,52.04440759637188,58,272,209,539,772
2017-11-18,1.695910988494284e+20,275001634110,17,193,202,54.36703102453102,21.36823593073593,13,92,77,182,375
2017-11-19,1.7618501922721602e+20,285595592055,8,81,312,51.35080808080808,19.8145202020202,15,106,68,189,270
2017-11-20,5.045439940272042e+20,817552383170,69,271,629,169.80924068986567,55.89917839105339,55,280,206,541,812
2017-11-21,4.067761421414373e+20,658915038562,64,206,427,130.15714105339106,37.94984217171717,57,214,165,436,642
2017-11-22,1.3254498084750942e+20,214615752333,25,56,254,38.172758838383835,10.140979437229436,25,70,47,142,198
2017-11-23,1.5685176292997805e+20,253920650099,36,113,281,45.41011183261183,14.172720057720056,14,96,58,168,281
2017-11-24,4.3342682516374317e+20,701356435806,99,301,669,166.6549920119563,54.221038188002474,62,168,234,464,765
2017-11-25,2.971257049198363e+20,480689810167,32,144,366,134.0862103174603,53.08635191197691,41,108,169,318,462
2017-11-26,1.729334098389282e+20,279665008072,33,156,470,53.81002802752803,18.380524891774893,24,93,68,185,341
2017-11-27,7.060419942554308e+20,1141403934535,159,485,1044,223.17454304954305,56.07573172198172,109,380,266,755,1240
2017-11-28,6.614024642671907e+20,1068896962469,88,348,744,223.5816818181818,65.06310173160173,94,327,286,707,1055
2017-11-29,7.122151575285887e+20,1150608741204,162,427,905,266.73947727272724,78.0739778138528,101,334,326,761,1188
2017-11-30,5.776558193224299e+20,932935058697,115,322,765,179.48992643005144,53.538585705960706,74,327,216,617,939
2017-12-01,6.256305736997434e+20,1010103715165,110,267,681,201.07237512487512,53.72596470658971,86,331,251,668,935
2017-12-02,1.0494373355396743e+20,169370052947,16,35,180,37.48912097162097,11.038867243867244,13,56,43,112,147
2017-12-03,1.546533567059392e+20,249530004301,17,69,147,51.73762662337662,12.121393939393938,14,96,55,165,234
2017-12-04,4.2946536791511204e+20,692678940963,81,233,454,120.24856968494468,30.380368506493504,59,243,156,458,691
2017-12-05,5.6751899377804555e+20,915052231475,124,261,645,177.4208962928606,57.82007919329347,51,325,229,605,866
2017-12-06,5.086156875549335e+20,819811985526,70,225,535,196.31385475635474,76.92101972101972,43,236,263,542,767
2017-12-07,3.9521663874062365e+20,636826513561,55,124,354,151.7969769119769,56.45654942279942,35,191,195,421,545
2017-12-08,4.704895617016374e+20,757879774838,69,232,515,155.18930952380953,57.30145346320346,25,256,220,501,733
2017-12-09,1.240083426033468e+20,199692109428,11,78,174,46.0209613997114,16.57132215007215,18,57,57,132,210
2017-12-10,1.37215414225445e+20,220884610321,24,62,192,49.75852143887858,17.072131003916716,19,65,62,146,208
2017-12-11,2.7078163704461302e+20,435743845708,33,168,405,97.47852753727754,32.46082251082251,29,141,118,288,456
2017-12-12,2.5020412359719738e+20,402483414761,42,142,241,83.35307488146773,25.498409992784993,36,116,114,266,408
2017-12-13,2.2959920483623725e+20,369216449875,20,76,219,86.36210317460318,32.470632215007214,22,104,118,244,320
2017-12-14,2.8993382600629528e+20,466086782873,31,83,200,88.77936327561328,28.84883838383838,33,162,113,308,391
2017-12-15,3.3711855132134906e+20,541778246738,69,843,642,113.35032467532467,47.27250721500722,32,168,158,358,1201
2017-12-16,1.5448682749742242e+20,248201465664,18,57,148,55.12736083361084,24.287062798312796,6,85,73,164,221
2017-12-17,1.243930040380455e+20,199783819858,13,54,112,50.93555194805195,21.441332972582973,12,55,65,132,186
2017-12-18,3.082815209031058e+20,494949078729,76,331,800,87.29280032467533,33.31654671717172,26,176,125,327,658
2017-12-19,2.3296066335681013e+20,373884388965,45,182,337,79.41310941043083,33.670086451247165,17,120,110,247,429
2017-12-20,2.1323828233471748e+20,342116672438,28,128,209,80.64619354256854,29.63367297979798,15,106,105,226,354
2017-12-21,3.7375212488192885e+20,599488100326,71,151,475,151.0064911014911,56.34544011544011,31,178,187,396,547
2017-12-22,3.134675150379392e+20,502629690952,37,115,265,138.954943001443,51.07651352813853,30,134,168,332,447
2017-12-23,1.6057155863472305e+20,257385188468,28,87,191,48.23800685425685,20.761911976911975,10,88,72,170,257
2017-12-24,1.2000080275839684e+20,192292462606,24,29,131,37.67816378066378,15.571123737373737,14,63,50,127,156
2017-12-25,1.1248521279826454e+20,180189926531,11,48,79,39.32443542568542,19.286713564213564,8,48,63,119,167
2017-12-26,3.082878204516101e+20,493661745695,48,250,493,96.86390584415584,43.64182016594516,24,162,140,326,576
2017-12-27,3.405608288757231e+20,545176619603,112,260,512,126.04593512968513,45.57850996225996,34,154,172,360,620
2017-12-28,3.7381137120397184e+20,598213390771,82,513,537,125.25277236652236,43.98238185425685,36,199,160,395,908
2017-12-29,4.023672256071684e+20,643686686234,168,514,783,118.57293068043067,34.0800188006438,64,211,150,425,939
2017-12-30,1.808917659961165e+20,289295437882,25,85,248,64.73517676767676,23.60802489177489,24,85,82,191,276
2017-12-31,1.4306163471037091e+20,228722632770,36,99,293,41.843105802927234,18.601932591218304,7,85,59,151,250
2018-01-01,1.2795308094678424e+20,204499113261,25,57,188,47.821295093795094,18.31109487734488,11,60,64,135,192
2018-01-02,4.646267408785969e+20,742304784707,150,355,1026,137.3251515151515,54.88907738095238,41,261,188,490,845
2018-01-03,4.62896727198058e+20,739314647348,133,280,972,144.37796935219663,51.000435294503475,42,238,208,488,768
2018-01-04,4.412437276579123e+20,704508965564,131,309,864,149.72234944684945,50.65487788600288,36,213,216,465,774
2018-01-05,5.7432127620044535e+20,916674021987,81,485,1203,264.3098412698413,94.66454545454545,40,211,354,605,1090
2018-01-06,1.3200249533127577e+20,210619908783,80,182,704,50.58537337662338,18.47036616161616,12,57,70,139,321
2018-01-07,1.3204638059820997e+20,210630371854,19,50,140,52.34988095238095,21.795528499278497,5,56,78,139,189
2018-01-08,1.7678195192291744e+20,281871406982,48,176,355,72.50389610389611,27.55347041847042,19,72,95,186,362
2018-01-09,4.554023288861571e+20,725928328795,73,251,577,143.38962070997786,54.256584526584525,31,243,205,479,730
2018-01-10,3.547489669352566e+20,565314189991,69,286,702,110.55500841750842,39.415080266955265,39,183,151,373,659
2018-01-11,4.662182455314821e+20,742684228989,90,315,809,148.5740725280011,57.061777855081424,38,245,207,490,805
2018-01-12,5.472968618607164e+20,871565850298,140,366,988,177.71623232323233,63.60134884559884,53,283,239,575,941
2018-01-13,2.0565925517367198e+20,327421341817,53,161,467,66.79070750017179,27.51151708410637,16,102,98,216,377
2018-01-14,1.6573967270348377e+20,263772702771,48,146,449,63.485495615495616,26.726358086358086,13,73,88,174,320
2018-01-15,2.1344287679693934e+20,339587781619,46,155,295,78.64159812409812,22.27993326118326,20,104,100,224,379
2018-01-16,4.6043011633929696e+20,732282386635,84,249,609,148.0584585137085,50.51017604617604,43,251,189,483,732
2018-01-17,3.652369162805355e+20,580703061718,50,187,422,125.5220243090243,44.05563636363636,39,165,179,383,570
2018-01-18,6.353654799220951e+20,1009847027716,225,537,988,203.78642496392496,74.35150703463204,60,326,280,666,1203
2018-01-19,5.974278293432395e+20,949248588004,208,473,953,180.4539502164502,64.7680735930736,47,319,260,626,1099
2018-01-20,1.9762181823794184e+20,313905552748,47,105,282,75.01134018759019,29.849848484848483,27,80,100,207,312
2018-01-21,2.3017103710908265e+20,365486280394,82,362,658,81.6549433106576,27.689146954236236,13,122,106,241,603
2018-01-22,4.9491789294751626e+20,785614137416,152,534,949,164.7773674242424,49.66757891414141,51,253,214,518,1052
2018-01-23,4.845904908181906e+20,768974708164,158,550,1494,161.47706216931218,66.82515734728234,59,222,226,507,1057
2018-01-24,4.5895282992231966e+20,728063669175,182,411,1009,142.49929689754688,39.64173544973545,63,240,177,480,891
2018-01-25,4.591357465750973e+20,728107279908,98,229,681,142.25970598845598,46.00795815295815,61,235,184,480,709
2018-01-26,5.042877457849386e+20,799447599195,180,614,1447,152.33926123876122,58.87693867243867,59,246,222,527,1141
2018-01-27,1.818801629189758e+20,288242255099,94,601,1152,51.176755565862706,20.784481292517004,16,98,76,190,791
2018-01-28,1.87693383198584e+20,297361244662,61,147,472,62.27241883116883,34.78694985569985,16,84,96,196,343
2018-01-29,5.508380233003011e+20,872410128973,165,391,1049,170.319451144094,62.82103896103896,49,278,248,575,966
2018-01-30,9.209818844391987e+20,1458149602424,306,978,2399,284.5288645983646,81.12173063973063,117,457,387,961,1939
2018-01-31,7.583273087510666e+20,1200267783996,155,333,1023,233.0423416120916,81.55331657231658,77,389,325,791,1124
2018-02-01,1.2612332193748175e+21,1995519423077,406,1329,3192,376.5593890177283,109.04958773964131,176,658,481,1315,2644
2018-02-02,4.6438138111801006e+20,734513276547,143,318,817,147.23147582972584,48.23580952380952,62,219,203,484,802
2018-02-03,2.6680973136954026e+20,421908519859,86,192,534,79.55412157287157,30.606939033189033,27,134,117,278,470
2018-02-04,2.2563407968885323e+20,356671575603,65,310,583,76.91643759018758,32.1320707070707,17,115,103,235,545
2018-02-05,6.243401529633665e+20,986597025349,133,245,819,183.83834183673468,62.66592635539064,76,331,243,650,895
2018-02-06,4.1221007268252307e+20,651188743742,97,225,618,138.0189381914382,41.11894480519481,63,201,165,429,654
2018-02-07,3.873764928016536e+20,611758247586,97,247,669,129.6307486957487,49.4736063011063,51,172,180,403,650
2018-02-08,5.202277037546153e+20,821291670958,94,161,500,187.81620083620084,65.45266865079365,60,208,273,541,702
2018-02-09,7.397531015548724e+20,1167484978484,193,476,1179,212.95128968253968,61.288800690050685,88,388,293,769,1245
2018-02-10,2.453846722496301e+20,387157183307,76,160,503,87.94793334751668,29.48766955266955,26,108,121,255,415
2018-02-11,2.0986100434904315e+20,331000786836,44,44,191,77.32761634199134,25.476210317460314,16,90,112,218,262
2018-02-12,6.452848950545939e+19,101736734046,12,51,61,26.559642857142858,11.98517316017316,8,24,35,67,118
2018-02-13,5.086778167298391e+20,801783108638,98,227,577,144.02396928468357,54.465251752216034,51,267,210,528,755
2018-02-14,4.722432420931969e+20,744120700102,146,283,843,150.65204365079364,56.12474657287157,49,222,219,490,773
2018-02-15,4.444567565945327e+20,700119671467,70,261,677,129.2803073084323,36.97245670995671,59,223,179,461,722
2018-02-16,4.060486710788609e+20,639409071317,129,729,757,127.74466446912875,45.857687719027005,55,190,176,421,1150
2018-02-17,1.7656321610891978e+20,277952751379,29,81,373,55.92863035113035,19.680256734006733,19,90,74,183,264
2018-02-18,2.335781578953222e+20,367587436263,45,162,267,76.10292815055315,17.455759920634918,36,112,94,242,404
2018-02-19,2.2207907045976542e+20,349379820488,47,105,344,76.23332972582972,17.194356060606058,34,107,89,230,335
2018-02-20,5.5253014908365767e+20,868947058282,119,220,787,183.84346991896993,55.9915359085359,73,256,243,572,792
2018-02-21,7.498554767098181e+20,1178915417237,172,293,931,222.61111803408232,59.80121876932591,86,396,294,776,1069
2018-02-22,5.606680210729679e+20,881197957944,109,268,776,179.38674314574314,53.606364718614714,68,264,248,580,848
2018-02-23,4.583805106148856e+20,720194207780,138,320,787,144.24420093795092,49.33297077922078,55,215,204,474,794
2018-02-24,2.5731486850953462e+20,404178748455,65,131,601,73.91015512265513,27.09261724386724,22,133,111,266,397
2018-02-25,2.458047858832468e+20,385968511219,61,191,632,67.73466871091871,22.84499639249639,17,131,106,254,445
2018-02-26,5.3440128149399273e+20,838848099934,112,264,658,160.8871592111592,49.48990728715728,57,266,229,552,816
2018-02-27,5.113585795666037e+20,802422252311,139,467,927,165.06187681762682,49.18842857142857,58,254,216,528,995
2018-02-28,6.045460389301813e+20,948368031479,139,371,877,188.4266102092352,62.40825992063492,71,295,258,624,995
2018-03-01,4.7975708541545205e+20,752356314828,123,222,602,147.99075779048994,36.92334132137703,70,227,198,495,717
2018-03-02,4.615162269540501e+20,723519490763,111,266,692,132.4383367003367,37.517474987974985,61,242,173,476,742
2018-03-03,2.1434346639446118e+20,335935993982,65,35,181,62.540460317460315,21.88940800865801,18,110,93,221,256
2018-03-04,1.727138561532398e+20,270590817574,39,196,183,62.52635101010101,15.829709595959594,14,82,82,178,374
2018-03-05,5.29011887355683e+20,828541323407,93,156,511,150.24935912698413,44.966344336219336,60,277,208,545,701
2018-03-06,5.272602253724787e+20,825546024718,110,259,731,160.09323328523328,58.184691197691194,39,247,257,543,802
2018-03-07,4.6625453260877994e+20,729804530764,176,341,1165,150.0627984977985,46.83820346320346,57,217,206,480,821
2018-03-08,4.4311689353062226e+20,693356048355,197,427,948,125.51040885040885,44.56760822510822,44,231,181,456,883
2018-03-09,5.035635123477951e+20,787675413715,247,614,1197,142.30971436301795,43.8813756828489,60,260,198,518,1132
2018-03-10,2.2755054548084185e+20,355839661682,99,279,585,69.56749845392703,25.81283498247784,21,116,97,234,513
2018-03-11,2.5779410335844562e+20,403004171976,58,160,446,95.11021645021644,30.564370490620487,25,102,138,265,425
2018-03-12,5.245578906286337e+20,819746398004,548,1323,2208,155.0263383580705,59.35027007318079,45,266,228,539,1862
2018-03-13,5.1111671090430647e+20,798498081402,112,335,639,160.08315913099247,46.41666991341991,62,258,205,525,860
2018-03-14,5.0643254602589274e+20,790937114596,90,241,652,161.12582027232028,49.92264347843514,68,251,201,520,761
2018-03-15,5.757928347601396e+20,898981179248,113,341,860,162.29812172747887,42.04489272830344,75,312,204,591,932
2018-03-16,4.103225290807613e+20,640428038482,120,552,928,123.00350708550708,39.595339646464645,53,200,168,421,973
2018-03-17,2.5349507404487813e+20,395535028641,24,97,234,81.04661255411256,23.618351370851368,23,137,100,260,357
2018-03-18,2.0287406490729254e+20,316446620915,41,230,669,66.23583910533911,19.007099206349203,28,94,86,208,438
2018-03-19,5.5226922848437895e+20,861151840129,147,435,1112,171.42666348928847,46.66656529581529,79,254,233,566,1001
2018-03-20,6.208023546609537e+20,967709858874,164,457,1311,188.85748502886003,68.46192514430014,92,283,261,636,1093
2018-03-21,5.712230969652558e+20,890158659005,121,735,1227,165.7469696969697,68.43012987012986,72,267,246,585,1320
2018-03-22,4.933003297062667e+20,768473625617,106,338,679,154.48508423520923,91.09706944444444,57,203,245,505,843
2018-03-23,4.925006979496725e+20,766994143593,114,663,1141,152.1456651034151,84.1359218975469,63,209,232,504,1167
2018-03-24,1.5151480077478108e+20,235893364514,96,110,499,43.41324765512265,13.410742243867244,25,66,64,155,265
2018-03-25,1.281037842472198e+20,199379703834,13,261,404,43.26486652236652,13.212445887445886,14,57,60,131,392
2018-03-26,4.187040561984018e+20,651448195079,94,207,556,125.03718049543049,48.606196879509376,59,202,167,428,635
2018-03-27,5.059657665098166e+20,786959320758,179,788,1447,160.31759455667788,74.67814357864357,59,225,233,517,1305
2018-03-28,1.2482398586714055e+21,1940868165527,470,955,2301,412.78764226514227,97.99854647667148,241,523,511,1275,2230
2018-03-29,1.2888369618383583e+21,2003389503119,526,1178,3368,416.19167053184907,113.36143041812684,199,564,553,1316,2494
2018-03-30,3.389779621457746e+20,526755545144,63,159,410,103.85682324950182,34.214266130694696,37,171,138,346,505
2018-03-31,3.645956336684987e+20,566372983319,133,271,977,124.61709577922078,35.458822330447326,56,153,163,372,643
2018-04-01,2.6569989354135005e+20,412622069091,54,218,455,76.5710933312719,38.14807977736549,31,119,121,271,489
2018-04-02,9.47497448477077e+20,1470915580400,349,706,2116,288.86768284955787,82.55959505772006,160,457,349,966,1672
2018-04-03,1.3981923443051903e+21,2169944870226,615,1174,3694,449.92017417767414,100.62604256854256,244,627,554,1425,2599
2018-04-04,8.558887726320952e+20,1327923882519,246,655,1655,249.71505068542567,67.5629252044252,124,414,334,872,1527
2018-04-05,6.568869783629194e+20,1018844657721,237,482,1260,210.71406487493988,49.71388726551226,90,331,248,669,1151
2018-04-06,6.266712304531168e+20,971686777840,314,499,1013,188.74453055211984,26.437502834467118,112,325,201,638,1137
2018-04-07,2.1715289974820835e+20,336605815089,40,362,516,62.191801837051834,15.826004592629591,23,121,77,221,583
2018-04-08,2.1035875610631068e+20,325964120196,128,333,994,59.39246608946609,10.989680375180374,22,124,68,214,547
2018-04-09,4.1202214259205774e+20,638255587963,72,476,888,109.39483130625987,31.31331465161822,36,231,152,419,895
2018-04-10,4.338192076426145e+20,671806782674,138,324,788,134.47117424242424,70.69081349206348,43,197,201,441,765
2018-04-11,4.438144809190585e+20,687078191267,86,568,984,133.44064574314575,64.26701839826839,54,212,185,451,1019
2018-04-12,4.745022518982009e+20,734348610214,112,331,781,145.42885667903525,66.03488481756338,52,221,209,482,813
2018-04-13,6.332192091347798e+20,979692112485,140,494,1148,192.9951396103896,54.55489826839827,96,317,230,643,1137
2018-04-14,1.6944387160475894e+20,262078182658,20,264,373,62.90695215895216,15.630459595959595,28,70,74,172,436
2018-04-15,2.040032852986497e+20,315427013063,54,352,479,76.2274543049543,36.78084415584416,21,82,104,207,559
2018-04-16,4.160481640985412e+20,643081971225,121,692,1075,133.5665808080808,43.513572510822506,60,188,174,422,1114
2018-04-17,6.35152943627474e+20,981441985681,103,233,759,197.73097895622897,75.75797186147186,61,320,263,644,877
2018-04-18,7.873312659047716e+20,1216204711091,315,573,2116,228.19164769754056,99.92376925158175,72,397,329,798,1371
2018-04-19,2.9808701372754887e+20,460297644463,75,157,493,96.85954184704184,27.038291847041847,37,141,124,302,459
2018-04-20,5.0847495695174966e+20,784979888432,157,514,1363,163.1390714285714,41.09441341991342,93,218,204,515,1029
2018-04-21,1.511147200991269e+20,233220307896,67,495,774,47.50949675324675,11.518685666185666,17,69,67,153,648
2018-04-22,1.9761171396580023e+20,304881298885,41,137,405,62.39554722394008,24.2922601010101,17,92,91,200,337
2018-04-23,4.89268809158278e+20,754624086485,91,318,904,150.21981024531024,46.129700937950936,61,233,201,495,813
2018-04-24,5.94257587637402e+20,916271869133,105,262,722,187.67836891019033,46.217168521954235,84,289,228,601,863
2018-04-25,2.7005286669115818e+20,416237568701,86,201,363,78.89751443001443,12.93636544011544,49,147,77,273,474
2018-04-26,1.182575595403887e+21,1822105787236,688,2028,5645,369.9073063140563,119.4956476070226,127,576,492,1195,3223
2018-04-27,1.7431067807617088e+21,2685227431365,742,1520,4003,542.7208103952926,185.65023282570604,237,783,741,1761,3281
2018-04-28,1.4259364257790532e+20,219589209931,26,116,307,45.571707835814976,13.865090187590186,18,72,54,144,260
2018-04-29,2.4467371751378207e+20,376676998688,36,97,289,78.5338428932179,15.644255050505048,38,112,97,247,344
2018-04-30,4.72687548699819e+20,727471776394,79,284,658,144.96580429292928,50.586888708513705,52,222,203,477,761
2018-05-01,4.788080970941808e+20,736664038697,94,397,889,151.17172808672808,42.85529845154845,65,226,192,483,880
2018-05-02,5.394730000280416e+20,829746612079,80,237,672,166.42763412513412,38.3821654040404,75,262,207,544,781
2018-05-03,1.5179305902115298e+20,233382036490,28,95,212,55.044566326530614,19.470614306328592,21,62,70,153,248
2018-05-04,4.1283622882180524e+20,634583176322,60,160,408,139.16573532948533,40.00446789321789,58,185,173,416,576
2018-05-05,1.896129240807584e+20,291374724003,16,88,240,79.14020502645502,16.95565476190476,37,67,87,191,279
2018-05-06,2.145121105502115e+20,329532027017,25,135,251,85.12072276334776,25.41871266233766,28,86,102,216,351
2018-05-07,5.156209423416588e+20,791838964029,100,304,913,177.14002243523672,64.1570978320621,43,231,245,519,823
2018-05-08,4.3629644228972334e+20,669819731500,82,267,752,150.5251887926888,37.434054834054834,71,186,182,439,706
2018-05-09,5.498072000179924e+20,843809992119,88,239,625,165.96488513801015,43.96743867243867,73,276,204,553,792
2018-05-10,4.704328459406536e+20,721778873468,99,191,710,162.15854187710437,43.35507133838384,69,200,204,473,664
2018-05-11,4.258338357919356e+20,653148067005,57,151,364,148.23266428016427,42.49092893217893,57,186,185,428,579
2018-05-12,2.2095041404777615e+20,338800048045,34,89,226,81.42407245928675,22.879977221191503,25,97,100,222,311
2018-05-13,1.812075985377004e+20,277771223467,25,122,283,78.34157287157286,24.194541847041844,22,65,95,182,304
2018-05-14,4.342685762312469e+20,665469745624,43,283,427,142.27615223665222,41.52503222703223,56,209,171,436,719
2018-05-15,5.111441079927989e+20,783038593677,107,292,730,166.60023581709297,48.6451031230674,59,240,214,513,805
2018-05-16,4.704604498258453e+20,720496619768,78,335,686,171.04309073862646,42.04668219181612,75,186,211,472,807
2018-05-17,4.177882592210239e+20,639630337307,57,115,438,143.3819733044733,43.61135642135642,58,186,175,419,534
2018-05-18,4.039764916381821e+20,618293665660,65,192,481,138.57183591871092,42.632513678451176,49,168,188,405,597
2018-05-19,2.0455288289677283e+20,312980377396,19,81,146,83.605424001924,26.09052958152958,20,81,104,205,286
2018-05-20,2.0363184957345363e+20,311471950958,61,73,229,84.50972582972582,30.475090187590183,25,73,106,204,277
2018-05-21,3.514958930902216e+20,537473062291,47,110,407,135.84952380952382,39.61317099567099,60,116,176,352,462
2018-05-22,4.045644869644317e+20,618433854665,86,394,984,145.25987366799868,35.727744408369404,66,159,180,405,799
2018-05-23,4.5368215562563623e+20,693297333179,200,495,1093,163.58194607641036,55.07973828420257,70,175,209,454,949
2018-05-24,4.318432730038293e+20,659736168376,145,233,922,147.50602705627705,42.04726028138528,62,189,181,432,665
2018-05-25,4.4800189234424244e+20,684210043034,181,303,1000,165.40874393595823,38.30756885178314,78,178,192,448,751
2018-05-26,1.8306423667044028e+20,279502715462,13,73,165,74.38681096681097,26.170101010101007,20,74,89,183,256
2018-05-27,1.6612076141509322e+20,253552881610,36,113,449,74.48474927849928,24.42521645021645,26,53,87,166,279
2018-05-28,1.521669815290763e+20,232182351596,23,67,204,56.787388476602764,22.359218923933206,15,59,78,152,219
2018-05-29,4.336366769114054e+20,661452584167,106,262,927,157.2341396103896,43.01165945165945,73,169,191,433,695
2018-05-30,5.119327969467975e+20,780648961842,110,533,1190,193.93430952380953,50.88145977633477,89,188,234,511,1044
2018-05-31,4.7704335551403144e+20,727221446682,163,564,1243,168.10349567099567,36.521249999999995,82,191,203,476,1040
2018-06-01,4.962599556674317e+20,756290905703,140,402,987,162.40361362248862,51.90936471861471,60,212,223,495,897
2018-06-02,1.9355893896183205e+20,294893197206,44,105,306,94.57490295815296,33.75204509379509,27,56,110,193,298
2018-06-03,1.9864974402645397e+20,302551114591,57,224,611,97.90919892805607,33.67399319727891,30,53,115,198,422
2018-06-04,4.877750436338051e+20,742668430267,101,286,753,180.98729112554113,44.62076082251082,70,205,211,486,772
2018-06-05,7.52000631160745e+20,1144628317611,241,490,1462,261.41123815073814,66.42796855690605,126,299,324,749,1239
2018-06-06,5.905553897138241e+20,898634341697,185,585,1477,205.5281072076072,57.407972384097384,81,257,250,588,1173
2018-06-07,5.003533959206971e+20,761133362842,142,389,905,165.04820046620046,53.057726731601726,65,220,213,498,887
2018-06-08,3.970037207848263e+20,603742877799,63,117,471,144.11453643578642,51.038870851370845,55,158,182,395,512
2018-06-09,1.3070191814383175e+20,198710312248,59,194,554,41.701828763828765,11.13098629148629,13,61,56,130,324
2018-06-10,1.7501121697966096e+20,265983211183,32,82,224,69.6131277056277,25.360477994227992,12,71,91,174,256
2018-06-11,3.9039417281955e+20,593145193947,46,176,463,146.935775012025,36.29416396103896,73,140,175,388,564
2018-06-12,4.0664129612621e+20,617640169591,66,253,644,148.10151781419637,38.88495336013193,63,162,179,404,657
2018-06-13,4.964003768302134e+20,753746714770,97,197,531,174.05066041828542,48.128180312742806,65,211,217,493,690
2018-06-14,6.043597433479792e+20,917391575763,287,723,1914,199.23827152477153,52.105219336219335,89,270,241,600,1323
2018-06-15,4.302486234616568e+20,652911799422,113,389,1101,152.75333573833572,46.98383207070707,62,169,196,427,816
2018-06-16,1.8546684979894184e+20,281364378043,95,76,465,70.35428932178932,24.224351551226547,20,68,96,184,260
2018-06-17,2.097316105493538e+20,318081587200,33,85,236,96.62907287157287,31.34675505050505,29,65,114,208,293
2018-06-18,4.065104129386989e+20,616320129627,54,156,441,152.25694252506753,55.08942130785881,48,152,203,403,559
2018-06-19,5.0050490203525684e+20,758591814770,88,203,613,159.01125577200577,57.36929437229437,68,210,218,496,699
2018-06-20,2.8467409292133623e+20,431323055454,81,190,513,117.11560185185185,41.72919372294372,34,91,157,282,472
2018-06-21,2.1610911579584617e+20,327335112789,104,134,379,69.90954094516594,20.07135551948052,35,97,82,214,348
2018-06-22,4.939706898182241e+20,748012092343,109,160,592,200.64847568172567,28.5754604978355,143,172,174,489,649
2018-06-23,1.86941958244418e+20,283004906281,49,69,251,80.34241883116883,24.485907287157286,24,65,96,185,254
2018-06-24,2.1531432242065238e+20,325856784314,36,128,402,85.08546536796537,21.542631673881672,37,85,91,213,341
2018-06-25,5.086618632292579e+20,769558430689,132,245,625,175.67608285233285,47.40323112073112,90,207,206,503,748
2018-06-26,4.0666843045145556e+20,615068968962,83,151,417,143.84887188208617,46.45964749536178,59,164,179,402,553
2018-06-27,4.189546424742293e+20,633464249869,57,127,327,153.72242827939257,35.97055924895211,78,169,167,414,541
2018-06-28,9.131319643381773e+20,1380236772150,269,794,1974,270.267775974026,76.03794642857142,118,447,337,902,1696
2018-06-29,5.77228832562541e+20,872258013348,174,258,782,180.27469067969068,51.402443389943386,79,268,223,570,828
2018-06-30,1.9855376018441264e+20,299950560312,55,266,797,74.86401226551226,20.787665223665222,30,77,89,196,462
2018-07-01,1.9052334873088904e+20,287725281238,22,80,164,78.40095093795094,22.949532467532464,31,61,96,188,268
2018-07-02,3.690165851298913e+20,557116340491,81,319,574,127.36192472342472,35.733162157287154,61,146,157,364,683
2018-07-03,3.072805998512898e+20,463778401168,47,105,349,93.32666678691679,29.832228715728714,39,147,117,303,408
2018-07-04,1.6028669300693395e+20,241851251509,58,131,259,63.574516594516595,19.027079725829722,25,57,76,158,289
2018-07-05,3.7550453564948716e+20,566396198276,55,123,439,131.22033802308803,37.7087619047619,63,149,158,370,493
2018-07-06,3.532970516749344e+20,532747152069,90,202,554,113.39113455988456,26.34395803270803,60,160,128,348,550
2018-07-07,1.5741292985441606e+20,237299588060,32,148,411,57.07522727272727,19.62598184223184,24,51,80,155,303
2018-07-08,1.6255238440571725e+20,244969104389,54,138,399,62.17961221054078,14.619262291280148,36,55,69,160,298
2018-07-09,4.7666123113471515e+20,718108496312,100,220,756,150.04425583521416,39.428538808413805,78,215,176,469,689
2018-07-10,4.209019489408715e+20,633928523911,100,221,761,147.76690242627743,39.9851819014319,65,177,172,414,635
2018-07-11,4.4241313273557e+20,666122724243,113,174,486,150.0072774170274,43.25302741702742,64,186,185,435,609
2018-07-12,7.335610882011583e+20,1104144608711,299,592,2128,241.74006349206348,85.9450560064935,86,301,334,721,1313
2018-07-13,6.615533471128228e+20,995469342214,219,530,1709,197.42546843434343,60.04449188311688,94,295,261,650,1180
2018-07-14,2.8099438585023205e+20,422712735082,80,197,604,100.5545101010101,31.73453932178932,54,92,130,276,473
2018-07-15,2.586951594718792e+20,389041815780,77,111,336,95.1894745069745,25.149093614718613,45,96,113,254,365
2018-07-16,1.1870184147264943e+21,1784499988708,390,1346,3929,363.90301058201055,106.69877873977873,164,544,457,1165,2511
2018-07-17,9.397150340109933e+20,1412351369343,368,591,1890,293.5010113306006,86.03822126881055,125,407,390,922,1513
2018-07-18,7.300154605503746e+20,1096855090333,301,526,1577,231.06278815166314,70.70083026695526,114,313,289,716,1242
2018-07-19,5.976862550837791e+20,897756802555,152,334,888,169.42899056036555,53.84809449082663,78,277,231,586,920
2018-07-20,4.805590908713152e+20,721615488446,125,467,1339,148.42918265993265,53.9269512987013,60,206,205,471,938
2018-07-21,2.0719295448695102e+20,311032149560,76,528,935,73.99767676767677,28.806756854256854,25,86,92,203,731
2018-07-22,1.9093110305977955e+20,286533662466,41,106,320,69.49413780663781,30.716435786435785,26,69,92,187,293
2018-07-23,5.5257923429419975e+20,829004876909,209,424,1175,172.6120586820587,56.51621031746031,73,250,218,541,965
2018-07-24,4.8328452669016284e+20,724842952927,87,171,751,140.558646713736,44.95522585549371,61,219,193,473,644
2018-07-25,5.54005860002494e+20,830633845952,266,462,1312,165.62983811558811,54.62394264069264,76,229,237,542,1004
2018-07-26,2.228085140779751e+21,3339588302075,1291,2303,7938,690.7804982841233,185.52673064435564,342,969,868,2179,4482
2018-07-27,2.60836761614747e+20,390841248490,55,143,480,73.1354062049062,24.089079725829723,27,125,103,255,398
2018-07-28,2.8954882294843084e+20,433774116652,54,247,581,88.39275998538498,24.864487234987234,37,145,101,283,530
2018-07-29,2.4974475376144545e+20,374019523020,53,91,380,68.01556036556036,21.661883116883114,29,135,80,244,335
2018-07-30,5.672619845225012e+20,849260372023,155,317,947,152.9257251082251,32.805850468975464,86,287,181,554,871
2018-07-31,5.899911759168285e+20,883033802958,125,260,891,172.6540096940097,49.193419497169494,99,262,215,576,836
2018-08-01,5.584332431465487e+20,835555921270,120,295,873,175.35218915343916,60.01095328282828,85,233,227,545,840
2018-08-02,5.699169301532474e+20,852471030311,214,354,1470,177.4030036075036,62.2183924963925,92,228,236,556,910
2018-08-03,1.3843242729267959e+20,206997584131,33,48,267,43.58506854256854,13.40516414141414,21,61,53,135,183
2018-08-04,1.9796256015773893e+20,295943102315,51,73,325,67.55147832062117,25.427830756545042,22,83,88,193,266
2018-08-05,1.395486184431956e+20,208552539814,18,64,157,42.48998196248196,11.16753427128427,21,65,50,136,200
2018-08-06,3.592683987130112e+20,536748502095,64,120,466,109.96977994227994,35.69125541125541,49,172,129,350,470
2018-08-07,3.973826160466663e+20,593522533671,102,140,695,140.44985942760943,39.47738113275613,59,163,165,387,527
2018-08-08,5.0846176421680873e+20,759200043551,164,210,989,177.32674703471133,53.84061287720216,59,200,236,495,705
2018-08-09,3.565815762875565e+20,532241408787,180,140,806,109.19683694083695,32.73017604617604,47,151,149,347,487
2018-08-10,3.7621172758982394e+20,561409466081,77,77,348,115.90577172827173,33.5398045010545,56,164,146,366,443
2018-08-11,1.3367379914604739e+20,199418863901,20,51,195,52.56283924408925,20.00604858104858,17,49,64,130,181
2018-08-12,1.584095662988053e+20,236248369739,26,35,144,61.23169733044733,19.96083393458393,27,55,72,154,189
2018-08-13,5.0010287129480285e+20,745607613413,95,148,744,161.06665524290523,45.790399531024526,78,208,200,486,634
2018-08-14,5.1570999596355905e+20,768661166523,155,289,1133,154.56338173400673,42.56050324675324,84,220,197,501,790
2018-08-15,1.4108142602091527e+20,210206824588,50,69,417,46.339824434824436,9.751824194324193,30,58,49,137,206
2018-08-16,5.078317550094818e+20,756472167715,137,226,756,149.2694166065416,43.84416865079365,71,234,188,493,719
2018-08-17,4.740164560858391e+20,705878418041,76,235,768,156.62811607374107,45.540726010101004,74,192,194,460,695
2018-08-18,1.6698387051899093e+20,248603322961,32,54,201,55.47797813297813,14.294969336219335,33,61,68,162,216
2018-08-19,1.6601616764325757e+20,247083769638,27,71,230,45.889729437229434,16.279085497835496,18,75,68,161,232
2018-08-20,3.6619900891917956e+20,544845063204,98,150,601,107.3306521164021,33.149589285714285,57,159,139,355,505
2018-08-21,3.962502122654089e+20,589386042644,91,122,605,133.2392227032227,51.86890721084471,52,145,187,384,506
2018-08-22,4.5006478706221384e+20,669235855770,98,140,788,153.06415283790284,46.97377405002405,72,182,182,436,576
2018-08-23,4.109798866864077e+20,610941560349,128,136,633,122.7844417989418,47.19851124338624,54,178,166,398,534
2018-08-24,3.191892229521336e+20,474350648014,64,122,372,107.33602994227994,33.15813852813852,46,127,136,309,431
2018-08-25,1.8392941114748178e+20,273264814256,25,43,117,60.64653499278499,21.25489898989899,31,68,79,178,221
2018-08-26,1.850346929794565e+20,274817168957,45,114,432,65.90567413142413,21.788081349206347,30,60,89,179,293
2018-08-27,4.239748772430559e+20,629505827207,95,142,590,144.90497474747474,46.97379329004329,58,160,192,410,552
2018-08-28,5.141182604240469e+20,763126327291,142,235,991,162.1879660894661,56.77110227272727,71,209,217,497,732
2018-08-29,1.1745291303179256e+21,1742857262036,429,904,2978,360.03285173160174,112.30947871572872,156,498,481,1135,2039
2018-08-30,2.7846823943387415e+20,413088610016,88,101,434,89.02799543049542,32.82224476911977,33,117,119,269,370
2018-08-31,6.855142220190458e+20,1016648079668,258,424,1349,204.73939565295814,60.5639987073112,95,291,276,662,1086
2018-09-01,2.2167432530292916e+20,328661962126,27,161,264,70.66229076479077,25.79618326118326,34,85,95,214,375
2018-09-02,1.9481148100645572e+20,288747651636,63,133,322,63.07278354978355,25.529395382395382,24,79,85,188,321
2018-09-03,2.0939345311627182e+20,310267954344,77,115,564,77.9816829004329,26.475427489177488,37,74,91,202,317
2018-09-04,1.0919845217677223e+21,1617492625858,472,1458,3985,278.47155856180854,89.59781734006734,109,554,390,1053,2511
2018-09-05,9.159581390663376e+20,1356422720213,233,524,1499,247.59790476190474,68.87814321789321,113,425,345,883,1407
2018-09-06,7.305411258226859e+20,1081514398993,220,210,1165,228.07069564694564,61.63184148027898,123,297,284,704,914
2018-09-07,4.359807641916813e+20,645256603458,68,136,451,131.1800901875902,37.21262175324675,64,188,168,420,556
2018-09-08,2.242947428770855e+20,331864388320,63,240,495,73.60769660894661,17.14521645021645,43,79,94,216,456
2018-09-09,2.077571021411089e+20,307300147924,44,65,341,68.99986291486292,17.308305375180375,35,90,75,200,265
2018-09-10,5.091849398693198e+20,752928287200,89,143,714,151.26936748436748,33.27540824915825,83,233,174,490,633
2018-09-11,6.320310201865115e+20,934299602059,201,348,1443,210.33063907785336,59.45420515529444,99,257,252,608,956
2018-09-12,5.2096804415959414e+20,769914782896,154,192,779,167.53895064591492,49.85843777915206,67,215,219,501,693
2018-09-13,5.003561472238035e+20,739223824230,135,256,873,165.9604260719439,52.45835566549852,77,210,194,481,737
2018-09-14,4.339300537893847e+20,640901171073,160,230,984,138.07562095312096,40.311381527423194,65,169,183,417,647
2018-09-15,1.936159132712496e+20,285884936126,41,158,368,70.15981096681097,20.798268037518035,40,66,80,186,344
2018-09-16,1.9368355328311768e+20,285901062759,20,71,167,63.6762987012987,23.88987554112554,22,80,84,186,257
2018-09-17,6.500256657390003e+20,959211219473,147,258,927,197.80570996595995,47.51505609668109,103,292,229,624,882
2018-09-18,5.564464459497511e+20,820905047180,114,152,643,165.06959385521884,46.349216269841264,92,238,204,534,686
2018-09-19,5.795873157827878e+20,854776629912,180,495,1415,164.54525432900434,30.23045364357864,96,274,186,556,1051
2018-09-20,6.694605263278265e+20,987043880845,161,267,1084,203.66053220985364,60.581862528344665,82,285,275,642,909
2018-09-21,3.0249797347257823e+19,44588327952,3,18,120,10.616244588744589,4.863138528138528,4,7,18,29,47
2018-09-22,2.024369102275288e+20,298298705471,36,75,253,66.28837301587302,17.201732503607502,33,82,79,194,269
2018-09-23,2.098153142246381e+20,309079698892,41,60,290,73.88513167388167,22.03076479076479,33,83,85,201,261
2018-09-24,5.607524685247965e+20,825798187889,155,279,997,167.8602047952048,51.45100649350649,80,229,228,537,816
2018-09-25,6.152657257536567e+20,905814579874,190,656,2078,183.9289071021571,64.05471804584305,74,255,260,589,1245
2018-09-26,5.308315234561799e+20,781288264427,147,315,1038,168.65931122448978,53.74923306191163,78,215,215,508,823
2018-09-27,6.355463844090273e+20,935137730221,177,308,1171,187.02891368419938,53.990642728303435,80,277,251,608,916
2018-09-28,4.339454863808128e+20,638327180544,73,147,498,131.21350324675325,40.97226485088985,66,174,175,415,562
2018-09-29,1.4539450879384437e+20,213812813603,16,35,130,50.32300072150072,18.740148629148628,19,58,62,139,174
2018-09-30,1.8102276566146256e+20,266127641093,22,52,225,59.56784541847042,17.36245806277056,35,69,69,173,225
2018-10-01,3.998645407338882e+20,587670095768,86,156,561,130.24377961159212,38.05394841269841,59,158,165,382,538
2018-10-02,7.727785758826212e+20,1135404980945,282,590,1909,214.34819272658558,67.22851138940425,93,358,287,738,1328
2018-10-03,7.143862927570525e+20,1049308417235,229,413,1252,209.3400233007733,55.71630435305435,117,305,260,682,1095
2018-10-04,8.00559311312743e+20,1175538133734,269,566,1862,241.52344587687443,48.75345528413385,132,356,276,764,1330
2018-10-05,6.268298228758387e+20,920171190247,185,161,783,210.411682728647,48.13871057513914,114,231,253,598,759
2018-10-06,2.107546830264959e+20,309303661867,61,149,562,68.34228234728235,15.823185425685425,42,82,77,201,350
2018-10-07,1.5314165054305065e+20,224681720945,78,67,404,43.82550775613276,12.38534181096681,27,63,56,146,213
2018-10-08,6.211927780211887e+20,911094204197,246,708,1191,186.21090343915344,41.898442550505045,111,260,221,592,1300
2018-10-09,5.657613152679411e+20,829570059956,149,315,1434,175.84757268194767,43.727852217227216,94,232,213,539,854
2018-10-10,9.492381797314759e+20,1391422834690,469,1238,3259,291.0415,59.91655375180375,162,418,324,904,2142
2018-10-11,2.0168698663040745e+20,295542239812,159,196,719,56.730680014430014,12.394606782106782,30,90,72,192,388
2018-10-12,6.819214755390907e+20,999036647475,203,261,1348,211.9648666291821,62.49099077509791,100,280,269,649,910
2018-10-13,2.060095989003561e+20,301728170785,44,110,344,72.83503727753728,19.315827922077922,44,64,88,196,306
2018-10-14,1.745414086434912e+20,255560520355,68,75,420,69.59390873015873,23.265003306878306,33,55,78,166,241
2018-10-15,5.827208482113055e+20,852946052318,109,151,508,168.97150468975468,42.76592766955267,93,269,192,554,705
2018-10-16,6.14486933174802e+20,899184726389,172,165,962,183.443634018759,57.58578727753727,83,252,249,584,749
2018-10-17,4.315399694912881e+20,631309485755,115,174,586,117.62918215382501,35.263616007008864,63,193,154,410,584
2018-10-18,5.011884035252078e+20,732978074731,148,203,483,128.55297239797238,32.375797258297254,79,231,166,476,679
2018-10-19,4.8345751918173395e+20,706840507915,113,143,577,127.6633192125335,21.990446377035664,82,225,152,459,602
2018-10-20,2.275841880022259e+20,332648653154,64,375,898,59.12295851370851,13.013622474747475,39,100,77,216,591
2018-10-21,1.8023239750715933e+20,263361532713,72,162,385,39.537609577922076,6.27410579004329,32,86,53,171,333
2018-10-22,5.377315771218381e+20,785511035375,146,275,1350,147.52640993265993,39.88915554353054,75,240,195,510,785
2018-10-23,6.265100416772158e+20,914939608582,141,334,925,168.23798328523327,36.72766396103896,97,288,209,594,928
2018-10-24,7.638977628563215e+20,1115243940493,258,547,1924,206.14998625712911,63.7409641053391,97,357,270,724,1271
2018-10-25,1.1452760966474514e+21,1671441046613,826,983,4693,335.5879897714719,84.54911094361987,192,505,388,1085,2068
2018-10-26,1.872988562926036e+21,2732948515995,779,1414,5091,552.0828498915106,97.85736592111591,341,804,629,1774,3188
2018-10-27,3.0733406360120997e+20,448325128235,160,163,769,71.56735960798461,16.80424663299663,43,150,98,291,454
2018-10-28,2.662481534425535e+20,388264919917,136,139,535,62.06822637085137,8.452085678210677,45,132,75,252,391
2018-10-29,1.4120752077276882e+21,2058548490068,736,1271,5771,369.41503316590814,82.17694853294853,209,678,449,1336,2607
2018-10-30,1.1429079880561215e+21,1665721105620,499,954,3485,310.78434817959817,56.675786325447035,185,535,361,1081,2035
2018-10-31,7.117819088340843e+20,1037087968945,195,227,1192,211.04317053317052,55.68248803280053,99,316,258,673,900
2018-11-01,7.723448912295567e+20,1124990902678,284,325,1320,232.71091197691197,59.738281746031745,121,342,267,730,1055
2018-11-02,5.503415463967902e+20,801405836076,189,252,1003,155.19862012987014,47.254357864357864,81,251,188,520,772
2018-11-03,2.604377427948026e+20,379146600233,90,105,392,84.30431653003082,27.21658042354471,41,95,110,246,351
2018-11-04,2.0016490282879697e+20,291312841842,28,83,251,62.03413247863248,23.127966117216115,26,85,78,189,272
2018-11-05,7.278562647723817e+20,1058964083683,262,440,1467,219.50199838521266,57.34938277331134,110,298,279,687,1127
2018-11-06,5.7335519066293024e+20,833958250902,143,256,964,164.50161075036075,45.133057810245305,87,235,219,541,797
2018-11-07,6.97603479676478e+20,1014375043394,254,306,1424,206.5323658094551,64.45913757472685,90,297,271,658,964
2018-11-08,6.3207360736914e+20,918843735954,192,291,1552,194.43892528305028,54.81297781385281,101,249,246,596,887
2018-11-09,6.14257617150291e+20,892685878322,121,189,721,162.06353715728716,55.66375,75,279,225,579,768
2018-11-10,1.5599544454378563e+20,226650953437,47,90,463,48.127503607503606,6.040243506493506,39,65,43,147,237
2018-11-11,1.5393541337078523e+20,223582133782,27,38,157,37.93302669552669,11.52386544011544,18,77,50,145,183
2018-11-12,5.2994108349318175e+20,769476452240,191,291,1353,155.74857715432717,41.18230272967773,64,249,186,499,790
2018-11-13,1.0007342148145429e+21,1452676175211,407,751,1412,296.54150728372156,74.82014460935889,156,372,414,942,1693
2018-11-14,7.555871223367803e+20,1096507674727,267,333,1567,228.87174007936508,58.102071248196246,129,287,295,711,1044
2018-11-15,7.930530783391954e+20,1150549478813,265,286,1058,235.87143072205572,48.27360930735931,136,337,273,746,1032
2018-11-16,5.306462142974292e+20,769644568529,158,188,814,160.94473785473784,26.636720779220777,110,215,174,499,687
2018-11-17,2.0849707901316196e+20,302321232261,76,116,398,66.122018999519,10.920202922077921,41,74,81,196,312
2018-11-18,1.4153158808156819e+20,205158811691,30,53,247,41.435715488215486,9.826654040404039,25,53,55,133,186
2018-11-19,6.270214429768472e+20,908617361283,226,386,1647,195.97532647907647,45.969027777777775,103,251,235,589,975
2018-11-20,1.0297429548303454e+21,1491813272146,313,517,2029,295.0271551312444,64.3488761209029,170,450,347,967,1484
2018-11-21,1.5979733767397677e+20,231423900315,25,37,181,50.847786796536795,13.552787397787398,27,58,65,150,187
2018-11-22,2.770464597785555e+20,401150116564,61,95,349,93.74048043623043,21.38279545454545,61,96,103,260,355
2018-11-23,3.837475361466476e+20,555473132997,79,533,1158,122.76956217393717,20.549173951048953,109,123,128,360,893
2018-11-24,2.1006397228084956e+20,303983643694,68,97,408,74.21749885762385,13.712795454545454,53,60,84,197,294
2018-11-25,2.0053717485618928e+20,290112763425,39,48,139,63.30329347900776,10.35498900570329,49,71,68,188,236
2018-11-26,6.423803110419798e+20,929034055450,189,359,1584,202.6725356026249,65.30245774067203,108,253,241,602,961
2018-11-27,6.393808667616636e+20,924452427280,202,265,1145,195.08008477633476,44.12135551948052,129,246,224,599,864
2018-11-28,8.606428699688963e+20,1243994239333,342,536,1821,251.83083258408257,54.409383288008286,151,369,286,806,1342
2018-11-29,5.5542888301959656e+20,802618751634,188,317,1272,157.3046626984127,47.13938612313612,72,238,210,520,837
2018-11-30,5.043319602308392e+20,728572217157,159,884,1194,160.94302044252044,47.292292809042806,73,179,220,472,1356
2018-12-01,2.3621554957796816e+20,341150704976,124,594,604,78.87826418951418,14.965661676286675,45,104,72,221,815
2018-12-02,2.052858228353376e+20,296400269233,96,229,473,67.39431146631146,20.10881367243867,30,76,86,192,421
2018-12-03,5.957679795079715e+20,859923235759,286,672,1977,185.22195616883116,68.98008658008658,81,221,255,557,1229
2018-12-04,6.665975124911296e+20,961873420668,207,332,960,190.350331718546,45.631727221191504,105,293,225,623,955
2018-12-05,2.739928879170733e+20,395266748407,88,123,407,86.4072857142857,22.506651875901873,46,104,106,256,379
2018-12-06,6.32775311847677e+20,912566860466,327,485,1882,193.8706795981796,43.56476898101898,117,265,209,591,1076
2018-12-07,5.0125090312443363e+20,722682296010,170,784,1223,144.62445889163746,38.88461221913008,74,215,179,468,1252
2018-12-08,1.6606035080214554e+20,239361293880,142,134,862,48.31408944891088,9.83297786538858,32,66,57,155,289
2018-12-09,1.3825746931394322e+20,199222861048,41,96,475,31.931147186147186,9.282002164502163,16,68,45,129,225
2018-12-10,3.9992156221825575e+20,576084175968,125,221,783,121.76369348244349,30.488622835497832,64,157,152,373,594
2018-12-11,3.989705153412659e+20,574568593762,103,138,790,126.36398208273208,41.01328703703704,51,157,164,372,510
2018-12-12,5.50375713206118e+20,792392137258,228,303,1418,159.6238027898028,44.398830086580084,83,222,208,513,816
2018-12-13,5.011960355192579e+20,721380379582,112,145,662,149.07875577200576,44.04291089466089,70,198,199,467,612
2018-12-14,5.4753186301305527e+20,787847605619,166,181,911,169.35829664779664,36.20856399156399,80,222,208,510,691
2018-12-15,1.3638622526719708e+20,196199051752,39,46,280,40.845970418470415,4.656210317460317,27,58,42,127,173
2018-12-16,1.6221688280347754e+20,233289599805,54,80,288,52.5806549006549,8.980850468975468,26,59,66,151,231
2018-12-17,6.093462795260118e+20,876048904495,111,230,698,182.94447186147187,44.62525937950938,98,250,219,567,797
2018-12-18,5.869670311227595e+20,843647741428,195,318,1080,180.41912670068027,43.47409892290249,96,237,213,546,864
2018-12-19,5.624392009891456e+20,808156646604,180,255,798,174.90543996512747,39.12126397907648,94,235,194,523,778
2018-12-20,6.788015759597572e+20,975093775914,263,249,1382,205.0847842204092,55.9721543040293,86,286,259,631,880
2018-12-21,3.9173109913007043e+20,562531902642,151,145,924,117.38003036315536,22.136526875901875,64,161,139,364,509
2018-12-22,2.2066743827872203e+20,316822386785,68,85,457,62.95403968253968,13.64865376984127,36,93,76,205,290
2018-12-23,1.7013717250022552e+20,244199788837,36,43,179,46.162632598882595,11.741029248529248,34,66,58,158,201
2018-12-24,5.719960981868763e+20,820745868257,275,1070,1631,180.67588323713323,38.110934343434344,112,225,194,531,1601
2018-12-25,1.4977793098675985e+20,214857902887,74,119,560,52.364338023088024,3.479094516594516,31,54,54,139,258
2018-12-26,7.588819716554395e+20,1088271383187,257,482,1999,222.35981096835263,76.75615766178265,101,308,295,704,1186
2018-12-27,5.952113145695285e+20,853346341620,159,181,1077,179.76372514060014,40.916587833462835,95,250,207,552,733
2018-12-28,5.8463352586799527e+20,837936050526,205,256,1178,170.17948064831992,44.97093717790146,83,243,216,542,798
2018-12-29,1.586096814050298e+20,227274236078,64,117,591,45.3945591115234,12.981560502989074,21,62,64,147,264
2018-12-30,1.6838071934830254e+20,241203347828,70,163,644,57.46886183261183,15.16642316017316,25,52,79,156,319
2018-12-31,2.8614442065440122e+20,409763414339,94,146,526,87.7492518037518,33.1107977994228,29,104,132,265,411
2019-01-01,1.9765516080317474e+20,282981462863,72,198,617,71.18420634920635,21.305218253968253,21,63,99,183,381
2019-01-02,6.871886733226014e+20,983537590641,266,369,1502,190.86386063011062,63.006614057239055,66,301,269,636,1005
2019-01-03,7.360326196455691e+20,1053180468756,273,315,1599,221.86943020735876,52.64784835402693,118,280,283,681,996
2019-01-04,7.211527488981618e+20,1031589141458,211,335,1357,219.17642539338968,65.72088577097506,84,311,272,667,1002
2019-01-05,2.498291520121279e+20,357284790475,93,121,651,90.6348915744749,26.978037518037517,34,87,110,231,352
2019-01-06,2.531634697590156e+20,361946258695,65,139,392,103.14332611832612,29.51828373015873,43,63,128,234,373
2019-01-07,8.788169710639126e+20,1256060292545,294,445,1900,272.4232126207126,92.71291305916306,105,337,370,812,1257
2019-01-08,7.448496991842526e+20,1064304469147,237,379,1718,246.7847207190957,81.84779761904761,97,281,310,688,1067
2019-01-09,8.674883156067984e+20,1239182145900,910,1258,2803,244.85966724479223,74.88357106782107,100,350,351,801,2059
2019-01-10,9.912727388388947e+20,1415621839272,339,456,1736,299.0135509602831,85.2946050900158,132,405,378,915,1371
2019-01-11,6.383081639520439e+20,911308325259,267,406,1855,202.6112349700564,53.04703622303622,91,242,256,589,995
2019-01-12,2.309051023677405e+20,329573915917,94,273,888,75.26447691197691,15.68433712121212,35,83,95,213,486
2019-01-13,1.7350969566795203e+20,247581530965,73,161,505,57.0476510989011,9.676713425463426,32,62,66,160,321
2019-01-14,4.8057621249821114e+20,685532191284,139,198,906,142.17163596985026,35.12144673778602,69,194,180,443,641
2019-01-15,6.771614063169963e+20,965680884189,222,323,1265,211.0410019325912,62.157029529993814,87,257,280,624,947
2019-01-16,6.458889912081745e+20,920848745169,223,371,1287,180.443230708445,40.86835474644403,100,264,231,595,966
2019-01-17,8.579224706171457e+19,122272428599,61,91,278,31.950497835497835,7.067157287157286,15,27,37,79,170
2019-01-18,6.354660936893613e+20,905475383003,188,269,1177,189.03607082732083,43.83678751803751,96,264,225,585,854
2019-01-19,3.064226479467884e+20,436508315041,97,181,780,99.19852633477633,24.60160804473304,49,111,122,282,463
2019-01-20,2.673986598637774e+20,380806212181,31,62,199,87.62809884559884,21.674925144300143,38,103,105,246,308
2019-01-21,2.1529189245959917e+20,306518911964,31,50,219,79.17233585858585,14.402025613275612,39,72,87,198,248
2019-01-22,5.906413987533969e+20,840657274015,111,168,743,168.54825667388167,45.669104437229436,75,256,212,543,711
2019-01-23,6.430499155591589e+20,915016516892,155,286,775,190.04176707551707,49.894523809523804,86,258,247,591,877
2019-01-24,5.224489132213782e+20,743202315133,122,237,993,163.87021103896103,52.40729677729677,66,208,206,480,717
2019-01-25,5.6399754054418465e+20,802084008843,135,145,872,179.7376568061568,44.57660245310245,86,225,207,518,663
2019-01-26,2.7664360093916748e+20,393321057697,136,721,1622,81.82753968253968,17.269265873015872,48,111,95,254,975
2019-01-27,2.6366357614493663e+20,374760358934,77,152,504,89.86589646464647,23.750692640692638,40,93,109,242,394
2019-01-28,5.547539545742654e+20,788280651441,129,212,853,160.1666474867725,45.90193867243867,68,243,198,509,721
2019-01-29,6.410735803688366e+20,910678816928,151,240,1040,189.25587936534365,34.92288080636295,110,256,222,588,828
2019-01-30,6.434672299283233e+20,913827177405,150,329,1252,184.76924716487216,54.45140993265993,85,270,235,590,919
2019-01-31,1.1673739702053408e+20,165737706560,63,80,386,36.23046639868068,10.944831478045764,21,43,43,107,187
2019-02-01,1.8453981273901344e+21,2619397140712,817,797,4397,517.83998004773,116.29770994745994,281,795,615,1691,2488
2019-02-02,3.482416180999976e+20,494165628525,132,137,580,83.23675444925445,19.64153409090909,48,163,108,319,456
2019-02-03,1.9765662481474083e+20,280404141956,46,103,296,58.09589142339142,22.857305217930218,23,70,88,181,284
2019-02-04,5.942910523023178e+20,842816254212,167,203,1167,158.4181187099937,41.25935592185592,77,258,209,544,747
2019-02-05,6.064919361029593e+20,859902356306,107,235,824,165.12104773929775,50.72802182539682,63,268,224,555,790
2019-02-06,4.613202204951876e+20,653875670576,97,183,878,121.5487031024531,35.68011093073593,62,200,160,422,605
2019-02-07,6.211238522144542e+20,880145731620,166,271,1011,164.72936147186147,34.72810606060606,72,294,202,568,839
2019-02-08,1.1562133721531291e+21,1637961317021,458,420,2178,329.563367003367,58.64334956709956,188,492,377,1057,1477
2019-02-09,1.0066988473929404e+20,142574388504,51,64,225,30.681013107263105,7.629695165945165,11,34,47,92,156
2019-02-10,2.24391838769612e+20,317710353069,46,63,245,61.29794660894661,16.977441197691196,17,106,82,205,268
2019-02-11,5.682906256660928e+20,804396395072,129,258,964,155.080851995227,34.087893426018425,78,252,189,519,777
2019-02-12,6.703409316665942e+20,948588736618,237,354,1122,181.1657163114663,47.616821497946496,92,291,229,612,966
2019-02-13,3.29815180947711e+20,466573394027,80,160,1099,90.1557432983683,20.577917207792208,52,145,104,301,461
2019-02-14,1.2473461612061713e+21,1764084699999,933,1528,5275,382.87252627443104,101.32210343228199,191,414,533,1138,2666
2019-02-15,5.3836020616830314e+20,761173047708,195,236,1126,156.9246161014911,28.89142436267436,105,204,182,491,727
2019-02-16,2.917323236441149e+20,412384509202,146,229,891,90.86157166907167,29.6651948051948,40,96,130,266,495
2019-02-17,2.3258976772392803e+20,328686736455,146,215,1002,67.27179241393527,14.247950937950936,37,92,83,212,427
2019-02-18,2.3156959350338096e+20,327154672995,60,122,374,60.052580792223644,7.2848439754689736,46,88,77,211,333
2019-02-19,6.049294736576642e+20,854374496323,213,546,1754,165.56105047069332,35.56204919088847,88,275,188,551,1097
2019-02-20,4.996896538191476e+20,705555210493,290,358,1481,134.88986751674253,30.610258838383835,73,215,167,455,813
2019-02-21,5.2951936480994256e+20,747465712118,116,286,751,142.96460852639424,26.74083125208125,84,242,156,482,768
2019-02-22,5.099139462118774e+20,719592386523,138,201,750,135.46171176046175,33.15794011544011,66,221,177,464,665
2019-02-23,2.308511887440283e+20,325694556978,59,132,436,66.74742424242424,7.791040764790763,38,91,81,210,342
2019-02-24,2.6721871446961422e+20,376896804935,141,145,865,83.91868806259878,21.70804714663643,35,95,113,243,388
2019-02-25,4.433328381083336e+20,625099279912,108,235,1062,128.17419672919672,36.11728715728715,58,177,168,403,638
2019-02-26,6.3823876136694555e+19,89969226364,17,35,96,14.479516594516594,3.611006493506493,9,32,17,58,93
2019-02-27,4.77732056599596e+20,673254576913,143,222,871,133.70624537499538,34.244954767454765,70,202,162,434,656
2019-02-28,5.8469513007080014e+20,823773553392,165,190,743,166.29835479797978,35.751152777777776,92,241,198,531,721
2019-03-01,7.027829300295903e+20,989833221108,323,397,1834,195.96356374115302,54.22483912251769,91,284,263,638,1035
2019-03-02,2.40197216073821e+20,338233503332,122,206,1139,66.53030483405483,18.914334415584413,29,93,96,218,424
2019-03-03,1.8186468154710704e+20,256017689701,72,90,547,53.74935913623413,13.543213383838383,24,71,70,165,255
2019-03-04,7.332161449727978e+20,1031887609272,318,472,1856,202.01856163677593,63.23149941163334,83,307,275,665,1137
2019-03-05,6.143365774432427e+20,864350334492,191,290,1204,184.68038963417536,54.58476128633271,86,241,230,557,847
2019-03-06,6.675024849166922e+20,938890153364,152,354,1041,200.9064826839827,58.97188943001443,79,293,233,605,959
2019-03-07,7.251070802275799e+20,1019643577792,178,317,1176,224.63275523088024,56.638619227994226,91,303,263,657,974
2019-03-08,6.679533116199168e+20,938997638839,149,204,864,210.15835533910533,55.91927002164502,88,262,255,605,809
2019-03-09,2.59527971572193e+20,364752509144,62,102,494,96.50098244348244,41.686426767676764,27,75,133,235,337
2019-03-10,2.22054033486717e+20,311997636954,57,113,403,87.57293974543974,31.773879870129868,27,60,114,201,314
2019-03-11,5.636448424349251e+19,79168923930,14,14,65,12.533328282828283,5.153098484848485,5,23,23,51,65
2019-03-12,6.069003793250472e+20,852266726904,136,199,931,178.58927218614718,49.02922077922078,72,258,219,549,748
2019-03-13,6.259023853809887e+20,878707352740,129,181,846,172.934757709222,49.88077470148898,84,260,222,566,747
2019-03-14,6.449134459841798e+20,905150137363,120,229,755,213.4975426887927,62.524471200096194,85,234,264,583,812
2019-03-15,8.752930672914981e+20,1228154593938,203,382,1381,246.01981856106855,84.6861845099345,82,377,332,791,1173
2019-03-16,2.2802081008853962e+20,319864402223,73,189,872,82.92309121434121,30.031163281163277,23,67,116,206,395
2019-03-17,2.2035033008561134e+20,309013772456,28,47,267,81.02428932178933,32.633759018759015,18,65,116,199,246
2019-03-18,7.22199937254982e+20,1012506286017,265,335,1411,219.34798534798534,72.73427669552669,86,289,277,652,987
2019-03-19,9.47351294525763e+20,1327820052436,380,367,1899,280.11725054112554,89.8437821067821,115,377,363,855,1222
2019-03-20,6.373436063339889e+20,893034667175,199,265,1298,171.66352342102343,53.75558351370851,70,276,229,575,840
2019-03-21,8.093733670336746e+20,1133819179263,160,275,1205,220.28560365560364,69.0150505050505,106,335,289,730,1005
2019-03-22,5.7117907311000014e+20,799929714732,200,230,1189,156.00801172438673,48.772077561327556,77,237,201,515,745
2019-03-23,1.8084057824209696e+20,253195854497,72,128,766,58.61737163299663,21.87509169071669,25,63,75,163,291
2019-03-24,1.9865761842263723e+20,278065127486,48,158,326,59.991637806637804,15.889915223665222,24,74,81,179,337
2019-03-25,6.583345975950992e+20,921238339008,110,216,877,182.727714496152,49.3482481060606,92,274,227,593,809
2019-03-26,3.287383079101383e+20,459872472614,59,74,328,89.03737012987013,36.04170274170274,30,142,124,296,370
2019-03-27,6.87642784262207e+20,961735664559,96,139,566,197.68025408850409,52.016466862502575,87,294,238,619,758
2019-03-28,6.889795517149125e+20,963343209727,170,205,836,212.38315074277574,75.25064203851703,79,273,268,620,825
2019-03-29,5.947113835784481e+20,831316954230,103,338,874,170.55840115440114,61.55979509379509,60,247,228,535,873
2019-03-30,1.2565360097418576e+20,175596505088,25,59,170,31.376257215007215,12.83412518037518,13,52,48,113,172
2019-03-31,2.157974628990577e+20,301484109463,55,79,422,72.52624945887446,29.828906565656563,17,73,104,194,273
2019-04-01,7.121446111000265e+20,994642889750,93,238,1090,213.07706409331408,59.86128336940837,87,281,272,640,878
2019-04-02,6.934387603723911e+20,968272872843,175,259,1194,193.56839105339105,64.02036616161615,71,287,265,623,882
2019-04-03,4.342656076333843e+20,606182629053,90,141,486,112.18206594001236,38.448568894729604,35,195,160,390,531
2019-04-04,8.05284419097176e+20,1123822453285,180,251,1052,200.58849786787286,64.89260094072594,93,360,270,723,974
2019-04-05,8.501050392395e+20,1186061920830,115,163,778,226.0993077200577,76.43915458152958,89,382,292,763,926
2019-04-06,1.604868141816508e+20,223855274482,39,56,358,48.66556277056277,12.902454906204905,16,61,67,144,200
2019-04-07,1.9957167059352047e+20,278283054507,35,117,444,71.442784992785,20.231100288600288,20,62,97,179,296
2019-04-08,7.026258679724405e+20,979485094802,147,229,1254,202.58675283446712,66.42390038136466,55,289,286,630,859
2019-04-09,6.604359166242193e+20,920450497533,152,232,820,216.5726905964406,67.2595670995671,83,238,271,592,824
2019-04-10,5.936914119116169e+20,827207269122,107,118,582,170.78684704184704,37.69307359307359,83,239,210,532,650
2019-04-11,7.925902098503592e+20,1104041063301,216,379,1309,231.0710600312386,58.17671992194313,119,297,294,710,1089
2019-04-12,5.840255751405746e+20,813303239270,167,251,1214,172.19598965848965,51.88045093795093,62,241,220,523,774
2019-04-13,1.820812868565691e+20,253491662477,34,70,309,64.99314965127465,22.130460858585856,16,56,91,163,233
2019-04-14,2.1007818248641957e+20,292387516910,13,52,160,79.14606932419431,26.795037878787877,22,73,93,188,240
2019-04-15,6.85201724335493e+20,953420660665,123,188,777,209.25378938191437,68.47554292929293,76,269,268,613,801
2019-04-16,6.37347095281305e+20,886591324115,107,161,735,189.98640705524633,58.62439767573696,63,255,252,570,731
2019-04-17,6.095833123894856e+20,847751048101,92,174,622,189.4373317099567,65.51779635642136,66,239,240,545,719
2019-04-18,5.5607590331407965e+20,773129808895,79,110,507,154.56523088023087,52.010509559884554,59,228,210,497,607
2019-04-19,1.622861543625309e+20,225573105582,62,82,415,47.01725803957947,13.221379290352504,21,62,62,145,227
2019-04-20,1.567441872126287e+20,217807622777,39,226,579,44.61422348484848,12.499887265512264,17,62,61,140,366
2019-04-21,1.2543751215116478e+20,174256150519,33,67,231,44.86860088985089,13.50075487012987,11,41,60,112,179
2019-04-22,5.926540555808018e+20,823093439157,86,167,750,166.73596981721983,38.93636544011544,87,246,196,529,696
2019-04-23,7.598389975461533e+20,1054989846611,245,490,2053,218.06742273929774,78.09443572631072,80,290,308,678,1168
2019-04-24,1.6593099728080214e+20,230308608783,39,54,267,49.456147186147184,18.78566378066378,11,75,62,148,202
2019-04-25,7.065779215105463e+19,98042733778,12,32,122,22.9934797979798,10.506440836940836,2,24,37,63,95
2019-04-26,3.107553516380304e+20,431097137236,138,240,750,89.46102633477634,34.35909451659452,27,121,129,277,517
2019-04-27,2.0646751569574953e+20,286371326969,59,52,282,64.58953222703222,18.26496091871092,22,72,90,184,236
2019-04-28,2.143944969138489e+20,297283111385,82,105,551,67.75616137566138,15.840822150072148,27,71,93,191,296
2019-04-29,5.659270131637292e+20,784500341342,91,275,866,158.46675986050985,42.93816197691197,68,230,206,504,779
2019-04-30,6.346184038274968e+20,879496578515,201,648,1811,168.27875735375736,36.28553541366041,73,278,214,565,1213
2019-05-01,5.145929095887356e+20,712974928487,136,193,979,145.35916305916305,40.929147426647425,58,204,196,458,651
2019-05-02,7.755152332793749e+20,1074193372155,100,169,658,177.1256547064047,41.26900306637806,69,401,220,690,859
2019-05-03,1.490790373405376e+21,2064427298289,537,557,2990,414.29259620009617,107.4577656024531,188,626,512,1326,1883
2019-05-04,2.8003903768236497e+20,387686418022,146,551,672,90.76441408128908,26.205129870129866,35,90,124,249,800
2019-05-05,2.812559617607353e+20,389265390306,97,122,576,87.2042518037518,18.278978715728712,33,99,118,250,372
2019-05-06,7.585068156766774e+20,1049516889804,126,196,1028,188.047247276533,37.7797311683026,105,341,228,674,870
2019-05-07,7.27244620827666e+20,1005976022466,130,287,942,181.55078117715618,42.01657882395382,87,325,234,646,933
2019-05-08,6.66655872780882e+20,921933450621,80,153,612,175.59689893439892,46.54955794205794,84,288,220,592,745
2019-05-09,7.310871958897159e+20,1010758668669,127,170,706,193.52353715728717,47.80095839345839,92,325,232,649,819
2019-05-10,7.527314498485199e+20,1040406925448,126,183,840,199.36564634439634,55.7678854016354,79,341,248,668,851
2019-05-11,1.9049068927106925e+20,263229630104,50,90,316,51.663156565656564,13.235348124098122,19,82,68,169,259
2019-05-12,2.232557889972243e+20,308417652873,38,91,274,60.88078463203463,17.89647186147186,19,98,81,198,289
2019-05-13,7.128636740191816e+20,984503647914,209,396,1176,177.74534962788533,33.20621691403834,95,325,212,632,1028
2019-05-14,6.217115806050522e+20,858375662414,120,248,908,163.81049285370713,49.01684987631416,72,259,220,551,799
2019-05-15,8.126485881354638e+20,1121711703081,198,299,1304,205.26107271696557,64.90811056998557,89,349,282,720,1019
2019-05-16,8.36606744473478e+20,1154489307139,163,276,1032,210.9125413244163,65.24859126984127,90,371,280,741,1017
2019-05-17,3.625471604638689e+20,500154005561,88,96,396,95.74264105339105,26.67827074314574,46,152,123,321,417
2019-05-18,1.4347233014479084e+20,197888510808,18,48,179,32.816946248196246,2.7792415223665223,24,69,34,127,175
2019-05-19,1.4578342888230183e+20,201017189636,44,60,260,34.81141414141414,11.199155844155843,21,58,50,129,189
2019-05-20,4.1715943810730013e+20,575038665958,198,84,391,103.10456987456988,35.298331529581525,36,179,154,369,453
2019-05-21,3.0647499795428246e+20,422343611538,134,287,1048,69.99273670773671,12.289209956709955,39,142,90,271,558
2019-05-22,6.798395078732925e+20,936676188948,207,367,926,166.26961652765223,42.89578747641247,82,301,218,601,968
2019-05-23,2.4442986377585862e+20,336664975238,70,74,364,58.46702137148566,16.226563981653268,32,103,81,216,290
2019-05-24,5.8745283669229096e+20,808965022216,142,209,755,147.01135702260703,44.98193903318903,57,258,204,519,728
2019-05-25,1.347389966591769e+20,185495642060,54,135,337,32.16275613275613,11.005627705627704,12,62,45,119,254
2019-05-26,7.249285160625784e+19,99769081023,259,201,1453,20.83008513708514,5.973782106782107,7,27,30,64,265
2019-05-27,1.574856025362928e+20,216695554991,76,147,653,51.70058445027195,13.673511315073814,21,47,71,139,286
2019-05-28,4.7262061551937225e+20,650125719831,131,269,925,134.30166967291967,35.79324314574314,66,163,188,417,686
2019-05-29,5.634680724725218e+20,774892239367,132,251,789,175.16414363414364,50.757416877104376,66,204,227,497,748
2019-05-30,4.547734007688707e+20,625249252664,151,778,686,131.32890007215008,33.901834054834055,62,158,181,401,1179
2019-05-31,6.806656358151822e+20,935584318229,176,355,997,184.82680625987769,53.20470369511441,69,276,255,600,955
2019-06-01,1.7021803602510502e+20,233908388409,78,65,443,46.66781325156325,15.034227994227994,21,58,71,150,215
2019-06-02,4.881490978887344e+19,67058285319,6,40,93,16.294278499278498,7.329936868686868,3,14,26,43,83
2019-06-03,5.814308349684505e+20,798507420291,265,468,1526,153.94778280251495,23.946707830859616,98,236,178,512,980
2019-06-04,7.644581751492236e+20,1049646969497,345,262,972,210.65556968494468,58.49904491341991,97,297,279,673,935
2019-06-05,5.499573041469894e+20,754916166514,145,190,924,158.98615836940837,44.05374663299663,67,209,208,484,674
2019-06-06,3.103130102287254e+20,425836334928,111,119,470,85.0784638179281,22.15437559133988,54,116,103,273,392
2019-06-07,6.105665485184429e+20,837674790069,334,926,1170,164.9044538926682,46.38161298357727,76,239,222,537,1463
2019-06-08,2.251855676215144e+20,308877747951,56,327,838,58.683881974506974,24.66528409090909,21,93,84,198,525
2019-06-09,1.9113548702116662e+20,262094526891,73,340,1150,57.743167388167386,18.084435425685424,19,67,82,168,508
2019-06-10,5.542444513670521e+20,759804806986,118,334,938,156.2292073204573,52.17858766233766,53,224,210,487,821
2019-06-11,5.862946104984117e+20,803533539665,133,380,1011,139.68164628427127,49.97879563492063,52,241,222,515,895
2019-06-12,2.6877152413064967e+20,368245178782,102,157,638,79.26892676767677,22.48428481240981,37,96,103,236,393
2019-06-13,4.385757624403508e+20,600766075159,126,263,689,121.21128856328856,38.242702168202165,51,171,163,385,648
2019-06-14,4.033934761893153e+20,552424080269,83,233,539,110.64881134738278,34.567304164089876,45,162,147,354,587
2019-06-15,1.2538359547108906e+20,171665625830,32,159,228,39.52084126984127,12.570483585858586,18,39,53,110,269
2019-06-16,1.6647691133167092e+20,227861094879,116,203,431,48.27647222222222,16.429415223665224,8,65,73,146,349
2019-06-17,4.630923229961145e+20,633676813157,67,192,598,136.1492359029859,38.84313492063492,51,167,188,406,598
2019-06-18,5.2599012448501373e+20,719558741196,129,287,958,136.72510347522848,51.555128607503605,50,215,196,461,748
2019-06-19,2.1684529472874463e+19,29657859218,22,7,77,4.6,1.8208333333333333,2,12,5,19,26
2019-06-20,1.986659337133698e+20,271622935135,52,107,329,52.76974001924002,15.616748075998075,18,76,80,174,281
2019-06-21,4.522555116098454e+20,618204766238,110,257,607,115.52860058922559,35.51816017316017,46,185,165,396,653
2019-06-22,1.3937307815716926e+20,190466998102,31,137,309,36.75419288119288,12.415518217893217,16,54,52,122,259
2019-06-23,1.5770454385604267e+20,215458919696,30,88,169,48.58253968253968,16.370277777777776,11,47,80,138,226
2019-06-24,4.19541734048383e+20,573028979619,60,224,508,103.85962878787879,24.475449675324672,48,174,145,367,591
2019-06-25,5.6832614477844205e+20,776050494059,99,288,892,139.61295001295002,34.59474446849447,60,240,197,497,785
2019-06-26,3.271610874220734e+20,446608084211,58,170,397,97.23876839826839,32.63682683982684,39,107,140,286,456
2019-06-27,4.382387066981431e+20,598108044854,83,252,686,103.02275252525253,30.43661796536796,54,188,141,383,635
2019-06-28,3.079011849559537e+20,420105971065,63,171,454,83.5249751082251,29.705304924242423,33,123,113,269,440
2019-06-29,1.5113282726400062e+20,206159090522,31,139,291,44.296878006253,12.214472402597401,13,61,58,132,271
2019-06-30,1.5232650913759334e+20,207732521433,32,209,400,54.678156565656565,18.22990981240981,14,44,75,133,342
2019-07-01,4.0099287401030995e+20,546696392205,65,193,473,110.17864898989899,35.080023448773446,37,162,151,350,543
2019-07-02,4.733228332042879e+20,645137801666,116,498,1238,134.63730152783725,49.051817002442,41,184,188,413,911
2019-07-03,4.333397556834228e+20,590495869051,80,255,531,114.24055194805194,32.91209866522367,55,171,152,378,633
2019-07-04,1.9838823497496707e+20,270267891627,66,270,605,52.32056818181818,20.92983225108225,18,81,74,173,443
2019-07-05,1.6405116776990284e+20,223416247621,39,142,328,45.634708994708994,12.326504329004328,18,65,60,143,285
2019-07-06,1.2851536410553562e+20,174989967618,47,151,406,35.32915739022882,10.003970830756545,13,52,47,112,263
2019-07-07,1.7447781553522023e+20,237501668940,43,173,397,46.74059343434344,13.845912698412697,19,72,61,152,325
2019-07-08,5.523053197197646e+20,751609472130,173,445,1090,152.1157774170274,48.67416125541125,53,221,207,481,926
2019-07-09,8.09773429060231e+20,1101693687138,234,375,1474,220.14885612073112,69.31597132034632,99,318,288,705,1080
2019-07-10,7.606079068785248e+20,1034551809311,186,423,1309,204.08597361368788,71.68639587198516,68,319,275,662,1085
2019-07-11,7.700378371950055e+20,1047110759689,190,383,1229,190.80827982202982,52.71505862193362,79,330,261,670,1053
2019-07-12,5.94377884192002e+20,808038412225,129,418,977,156.2950985958486,50.57549537037037,60,228,229,517,935
2019-07-13,2.3574956294195072e+20,320418245523,113,216,942,59.585830697080695,23.94043921356421,14,104,87,205,421
2019-07-14,2.17427064652462e+20,295428461924,59,287,699,69.02733525733525,36.438418109668106,19,64,106,189,476
2019-07-15,3.4523002099405128e+19,46895974332,5,15,67,9.526488095238095,4.219047619047619,2,17,11,30,45
2019-07-16,2.463531109953015e+20,334545843158,67,157,454,69.23158910533911,25.07090458152958,28,87,99,214,371
2019-07-17,3.604343291500033e+20,489339587521,99,175,653,100.4978373015873,41.06344787157287,45,125,143,313,488
2019-07-18,6.415882034409915e+20,870847628435,137,292,799,175.4019009139009,55.721190716690714,79,243,235,557,849
2019-07-19,4.4129645863055616e+20,598837069728,134,336,1198,112.66121332371333,34.67585227272727,50,173,160,383,719
2019-07-20,1.5213848610028713e+20,206398858270,46,586,1051,38.988679653679654,9.003311688311689,19,67,46,132,718
2019-07-21,1.4988308493716298e+20,203283458785,42,160,262,39.54872835497836,7.998874458874458,18,68,44,130,290
2019-07-22,3.8175393540224804e+20,517621607280,60,218,545,95.39143447227376,31.01136430632859,31,161,139,331,549
2019-07-23,6.137604996615942e+20,831992112498,249,685,1527,151.932108714698,44.11153692537621,71,235,226,532,1217
2019-07-24,6.889507238306496e+20,933693132221,279,464,1556,180.4028781866282,54.4606259018759,88,269,240,597,1061
2019-07-25,1.0794155951969824e+21,1462413433295,466,996,3432,285.35684435934434,73.93815136252636,140,430,365,935,1931
2019-07-26,8.845294268123619e+20,1198135839321,215,518,1663,208.8744088203463,52.080749007936504,111,373,282,766,1284
2019-07-27,2.4718658790727978e+20,334744559525,39,180,367,63.12388744588745,18.329691197691197,22,108,84,214,394
2019-07-28,1.8371941892463084e+20,248726883708,62,199,435,53.14575757575757,16.150403138528137,13,65,81,159,358
2019-07-29,6.010440627127252e+20,813494257976,160,266,867,146.47950757575757,38.48079861111111,68,262,190,520,786
2019-07-30,5.38786685013953e+20,729053853838,125,463,1213,135.32997093184593,38.8049068061568,64,235,167,466,929
2019-07-31,5.285485059992425e+20,715013366986,139,309,1115,126.44597943722944,39.74245941558441,46,224,187,457,766
2019-08-01,6.814277566545e+20,921588837290,217,412,1503,178.12835497835496,46.249742965367965,75,275,239,589,1001
2019-08-02,5.554957362328332e+20,751081291730,150,455,1162,145.1784485930736,40.56138365800866,64,224,192,480,935
2019-08-03,2.4309764824378953e+20,328614340455,111,243,541,68.12828884078884,15.229899591149591,30,95,85,210,453
2019-08-04,1.6211976141890578e+20,219089259540,26,160,239,48.18520021645022,20.79694745069745,8,59,73,140,300
2019-08-05,5.6530348975467744e+20,763730322179,179,262,997,150.0652362914863,47.26977543290043,58,230,200,488,750
2019-08-06,4.785634544274066e+20,646387263142,175,192,795,118.65491011303511,33.233422619047616,61,193,159,413,605
2019-08-07,5.088434790866161e+20,687116292931,146,308,723,135.49416666666667,37.57764971139971,67,205,167,439,747
2019-08-08,4.8233519773376525e+20,651153021744,125,204,838,136.2658086820587,46.73826899951899,48,179,189,416,620
2019-08-09,3.7230170867111566e+20,502479671089,88,180,545,112.90169312169311,28.773566017316014,49,125,147,321,501
2019-08-10,1.1949713829940501e+20,161240340261,55,134,335,36.77812548562549,7.914318043068042,14,43,46,103,237
2019-08-11,1.2765891239364678e+20,172208103662,38,96,209,33.687472111222114,10.76995102120102,17,41,52,110,206
2019-08-12,3.552426845258341e+20,479079958176,84,176,580,102.77897546897546,27.701249549062048,40,124,142,306,482
2019-08-13,4.807647454186372e+20,648200926785,76,167,555,118.17184343434343,32.43061928811929,53,202,159,414,581
2019-08-14,5.006717427357651e+20,674857319361,114,153,667,130.5414390933141,44.47666756854257,57,189,185,431,584
2019-08-15,5.531072947391353e+20,745356503002,146,210,697,149.35526394901396,34.28574404761905,84,208,184,476,686
2019-08-16,5.2305499870683745e+20,704681767954,82,127,427,129.579683020683,34.198161796536795,57,217,176,450,577
2019-08-17,1.7556502142006654e+20,236472044041,16,63,144,42.07980339105339,15.670651154401154,11,79,61,151,214
2019-08-18,1.7446207256926713e+20,234920245572,20,146,189,45.30025613275613,14.29970779220779,10,71,69,150,296
2019-08-19,4.3514489363308315e+20,585770907577,76,164,494,104.33596507659007,28.222969599844596,44,185,145,374,538
2019-08-20,5.8307029864280673e+20,784721114175,84,180,492,116.98786556036556,29.852948232323232,77,268,156,501,681
2019-08-21,7.008231629798277e+20,942967917162,105,199,609,158.1798424214674,49.614925264550266,77,315,210,602,801
2019-08-22,6.206922686874954e+20,834933609983,69,220,445,141.35039914450627,51.02430826118326,43,280,210,533,753
2019-08-23,7.956297709426215e+20,1069967206824,127,239,715,203.88892766955266,52.042930194805194,92,336,255,683,922
2019-08-24,2.7615909211906077e+20,371295347220,78,170,607,60.191298899513185,15.150302257266542,23,132,82,237,407
2019-08-25,2.319614452592552e+20,311782078046,39,145,222,61.057366883116885,18.394180735930735,25,91,83,199,344
2019-08-26,2.250478332070022e+20,302400734634,17,71,168,53.71470238095238,17.600102813852814,22,99,72,193,264
2019-08-27,5.388528581235382e+20,723914290841,136,250,702,133.74152161727162,30.231628427128427,78,223,161,462,712
2019-08-28,6.790197323099472e+20,911992874712,87,178,522,138.5808226033226,32.56781107781108,71,347,164,582,760
2019-08-29,7.072516507951734e+20,949655927980,105,236,461,151.72397388722388,43.0311249028749,64,332,210,606,842
2019-08-30,7.016260154052161e+20,941870497120,104,279,808,152.17362674362673,38.326562650312646,72,322,207,601,880
2019-08-31,2.2070661249503396e+20,296210367065,31,168,231,53.5524258056758,17.499031024531025,16,100,73,189,357
2019-09-01,1.985854824369655e+20,266448414162,22,183,270,62.08113756613756,15.640561568061566,22,73,75,170,353
2019-09-02,2.5707428734858664e+20,344834980631,27,168,229,58.79330687830688,22.67240079365079,23,106,91,220,388
2019-09-03,7.890029949432398e+20,1058076580532,105,252,798,189.82364737511165,40.163194813784095,98,332,245,675,927
2019-09-04,6.641217759525466e+20,890397235486,126,254,1227,170.58101594173021,52.353041254380535,71,269,228,568,822
2019-09-05,7.122961427749865e+20,954725133522,156,287,868,163.5889823575895,55.77642537621109,66,310,233,609,896
2019-09-06,6.13052074793473e+20,821512531056,105,292,756,136.93473665223664,45.15883116883116,54,270,200,524,816
2019-09-07,2.60977973247947e+20,349632196795,43,162,357,57.77900659525659,21.51834151959152,14,117,92,223,385
2019-09-08,2.095544132106132e+20,280663125812,51,146,301,55.72243265993266,18.231660353535354,17,71,91,179,325
2019-09-09,4.4383010981046734e+20,594285799360,75,202,645,118.99636063011063,39.92658189033189,42,165,172,379,581
2019-09-10,4.990175270603514e+20,668018748737,92,240,669,123.34905251494537,36.678075139146564,47,204,175,426,666
2019-09-11,4.183259988864866e+20,559850776029,65,155,407,116.02325847763348,31.903349567099564,57,151,149,357,512
2019-09-12,4.6651093156806984e+20,624181193164,132,244,840,114.6434476911977,40.24276803751803,35,198,165,398,642
2019-09-13,3.353323388492599e+20,448556262374,63,181,546,89.19639430014429,22.980816197691198,39,132,115,286,467
2019-09-14,1.383950791510312e+20,185078485076,36,233,690,43.489787157287154,15.468106962481961,12,39,67,118,351
2019-09-15,1.5604033959115017e+20,208617967615,36,117,331,41.245945165945166,8.83487012987013,18,59,56,133,250
2019-09-16,4.283693957754625e+20,572555988247,113,260,814,112.28683754208754,33.654892857142855,41,174,150,365,625
2019-09-17,3.615809323193825e+20,483168784157,111,180,654,94.77217953342954,27.54737554112554,46,135,127,308,488
2019-09-18,4.4858888046706616e+20,599286883606,85,102,550,113.86025462500463,33.08213365800866,50,177,155,382,484
2019-09-19,4.9689015165197844e+20,663645038000,154,255,1075,126.04385948773448,43.64175529100529,39,194,190,423,678
2019-09-20,4.9940046484013607e+20,666821213252,149,200,784,136.6010125985126,34.03651665464165,67,192,166,425,625
2019-09-21,1.7513010733102318e+20,233790682490,52,97,327,43.254439634439635,12.833268398268398,10,80,59,149,246
2019-09-22,1.6343086118531462e+20,218113015115,70,124,351,49.071883735312305,13.318692176870746,18,54,67,139,263
2019-09-23,5.4337404645318813e+20,724992226135,103,256,773,145.39610812203668,35.744726628530195,69,196,197,462,718
2019-09-24,2.3178213997308864e+20,309161658377,68,103,389,57.054614968364966,9.161078366078366,31,98,68,197,300
2019-09-25,5.978535707029399e+20,797267565704,200,241,1116,151.63341125541126,39.747531505531505,62,241,205,508,749
2019-09-26,5.203277950194076e+20,693720872136,133,243,526,128.47789923039923,33.376023328523324,63,209,170,442,685
2019-09-27,4.863401545869535e+20,648241372950,162,402,1306,128.36708546083545,32.23037418599918,57,184,172,413,815
2019-09-28,1.5430482891894414e+20,205626519671,59,51,159,38.47145238095238,15.466439033189033,8,64,59,131,182
2019-09-29,1.8499476801412805e+20,246453280672,50,47,280,47.25526166426166,15.93593722943723,10,79,68,157,204
2019-09-30,4.8443694570303173e+20,645209942643,143,163,587,119.21497351920566,38.128600572047,45,205,161,411,574
2019-10-01,5.576752417246422e+20,742579081512,120,99,534,133.80203890686033,41.65009091107305,61,222,190,473,572
2019-10-02,4.175027653249368e+20,555787996930,68,82,437,113.13252044252044,32.03307178932179,54,159,141,354,436
2019-10-03,2.878749500011169e+20,383110470228,43,78,298,72.06333122895623,21.01931402316819,24,115,105,244,322
2019-10-04,3.198192212991385e+20,425525122306,98,97,576,80.7663961038961,23.17099597162097,34,137,100,271,368
2019-10-05,1.1686404844621454e+20,155457222819,34,45,163,25.746004689754688,5.860963804713805,15,53,31,99,144
2019-10-06,1.0863488075453366e+20,144473391531,46,92,311,27.907683982683984,10.837468133718133,8,44,40,92,184
2019-10-07,3.012094966842859e+20,400466858628,69,80,495,81.14877855940355,26.595307539682537,33,104,118,255,335
2019-10-08,4.194582568031929e+20,557543057415,52,85,326,109.28488997113998,34.07924783549783,47,151,157,355,440
2019-10-09,3.545777697325411e+20,471188420291,52,88,394,81.45448497335997,14.94867284104784,40,159,101,300,388
2019-10-10,4.019788732363149e+20,534043123003,93,108,424,109.88341245791246,36.124596500721495,44,141,155,340,448
2019-10-11,4.328510114338974e+20,574913323651,86,118,563,124.2315389009139,30.205681818181816,58,136,172,366,484
2019-10-12,1.3959125041597519e+20,185363674532,45,46,160,37.80619382601525,9.322509791795506,14,49,55,118,164
2019-10-13,1.3963623645947367e+20,185374400035,55,80,330,47.304368686868685,12.069215367965366,19,40,59,118,198
2019-10-14,1.5507989603086772e+20,205811310072,33,41,172,42.64464646464646,10.355723304473305,15,65,51,131,172
2019-10-15,4.8667183310316326e+20,645742781310,120,217,809,128.35097356347356,39.189660894660896,43,211,157,411,628
2019-10-16,4.8326333296831824e+20,641063626630,81,131,605,109.92344920291349,33.028119717584,49,204,155,408,539
2019-10-17,4.644493326433654e+20,615956659822,125,121,684,106.98162375323089,36.60807221548293,40,199,153,392,513
2019-10-18,4.456327503989396e+20,590849077437,100,120,708,105.44336534992784,31.913882124819622,60,161,155,376,496
2019-10-19,1.6716165666759154e+20,221580176013,111,604,1279,40.56344516594517,15.728015873015872,12,66,63,141,745
2019-10-20,1.4705293009507408e+20,194875687447,28,152,377,32.97129329004329,11.13833694083694,13,56,55,124,276
2019-10-21,3.8435127433558655e+20,509219016328,79,95,427,86.97702956765457,28.19488879176379,27,169,128,324,419
2019-10-22,9.374893849271907e+19,124169451664,14,12,75,23.595070346320345,5.146482683982683,9,39,31,79,91
2019-10-23,4.961712548624422e+20,657029464782,90,174,683,119.88111778499278,29.745499278499278,60,194,164,418,592
2019-10-24,1.8963256544022658e+21,2510388721764,1073,1360,6500,475.7708048598227,110.40076680924895,255,744,598,1597,2957
2019-10-25,1.8670869398683378e+21,2471196794632,622,722,4149,504.4001985930736,111.61280254930254,287,646,639,1572,2294
2019-10-26,4.4312976414367973e+20,586385814095,216,231,1340,108.29892075517076,38.10814874939875,46,162,165,373,604
2019-10-27,2.0916684039462715e+20,276704216330,56,99,341,58.36139864764865,17.15124639249639,21,79,76,176,275
2019-10-28,5.860918114706747e+20,775130819181,117,229,814,144.27257124819624,51.03362614237614,48,223,222,493,722
2019-10-29,4.5783064812352235e+20,605356797642,108,226,883,127.04042827542827,46.290641395641394,43,154,188,385,611
2019-10-30,4.2942215652611673e+20,567651646058,91,252,836,115.15740644771894,28.687862935675433,48,160,153,361,613
2019-10-31,3.355476736004194e+20,443452262275,60,112,425,87.79156277056276,26.284791095478596,42,124,116,282,394
2019-11-01,3.451752108731921e+20,456058325821,117,233,1021,89.5150487012987,38.88178932178932,24,127,139,290,523
2019-11-02,1.2977664977200382e+20,171424176624,29,71,225,29.931964285714287,10.60867784992785,10,52,47,109,180
2019-11-03,1.3934734360305007e+20,184016687640,46,77,269,38.11799783549783,9.055808080808081,22,45,50,117,194
2019-11-04,3.848121596066151e+20,508040064968,100,169,564,98.11976757369614,30.342649067202636,34,144,145,323,492
2019-11-05,4.099516272254413e+20,541099315584,43,149,293,103.98117312317312,39.83548205035705,40,135,169,344,493
2019-11-06,3.194776196403381e+20,421577173216,81,130,607,82.7943394145537,35.55345498350855,26,108,134,268,398
2019-11-07,4.650624262111736e+20,613525162779,100,215,730,117.80927849927849,33.7297132034632,48,171,171,390,605
2019-11-08,4.1151564751625244e+20,542761042038,102,241,794,97.40057067271353,26.241441713048854,60,155,130,345,586
2019-11-09,1.2647318246591617e+20,166770063724,36,103,483,28.358133116883117,10.778885281385282,12,52,42,106,209
2019-11-10,1.1338544095197584e+20,149472518271,29,90,252,26.179914983164984,10.062790043290043,13,46,36,95,185
2019-11-11,3.498146123172208e+20,461030950245,69,184,495,80.63743506493506,21.51414502164502,46,123,124,293,477
2019-11-12,4.060439490357089e+20,535012312592,104,189,717,105.36244017556517,33.20209776334776,46,144,150,340,529
2019-11-13,5.63867223849189e+20,742766530106,177,271,1117,133.69200974025975,39.226307359307356,47,216,209,472,743
2019-11-14,5.18618002007582e+20,683002545916,226,466,1724,133.15944144876286,39.41939525355596,57,180,197,434,900
2019-11-15,5.594206322170263e+20,736551040169,460,566,2099,144.29643138343138,37.430085918710915,68,203,197,468,1034
2019-11-16,1.8771842687772918e+20,247102651550,90,173,518,39.44455946830947,6.992373297998298,27,80,50,157,330
2019-11-17,1.8897406300300857e+20,248690853501,297,184,708,48.836847286311574,16.46334969593898,21,69,68,158,342
2019-11-18,4.666146166388893e+20,613895233804,155,399,1280,127.21416469112897,32.06497487631416,77,151,162,390,789
2019-11-19,4.930799598670628e+20,648559432767,145,195,687,127.54528138528138,31.909902597402596,68,193,151,412,607
2019-11-20,5.195660572727255e+20,683228579906,103,192,616,127.89010401635402,40.99718704906205,61,195,178,434,626
2019-11-21,3.305162140684453e+20,434519659003,53,120,316,81.26120851370851,25.44900072150072,31,128,117,276,396
2019-11-22,3.8572196487857884e+20,506968144470,105,192,668,93.02679653679654,24.26431637806638,43,156,123,322,514
2019-11-23,1.425861579138091e+20,187366551091,60,90,351,32.903375901875904,13.017869588744588,10,55,54,119,209
2019-11-24,1.5222193071804226e+20,199974578147,61,120,431,34.66195863395863,13.777624098124097,9,62,56,127,247
2019-11-25,4.9277865084925634e+20,647198760125,88,203,659,134.34121813371814,42.39419011544011,55,170,186,411,614
2019-11-26,5.5169425852185516e+20,724398249312,168,289,995,151.90462247474747,54.8895499037999,48,204,208,460,749
2019-11-27,6.826327780885574e+20,896099437295,188,282,1340,192.66757210712566,56.35763433656291,89,216,264,569,851
2019-11-28,2.172001860251448e+20,285063690051,44,204,443,60.85998598623598,24.403279914529914,17,71,93,181,385
2019-11-29,3.577254326352177e+20,469361211663,79,202,529,99.19291366041367,29.376518759018758,50,119,129,298,500
2019-11-30,1.356851127609233e+20,177988203874,59,106,372,37.45290959040959,9.559426406926407,18,46,49,113,219
2019-12-01,1.8257047124189587e+20,239431108419,86,131,348,47.58407287157287,16.47805916305916,24,55,73,152,283
2019-12-02,6.115733328333864e+20,801827446874,87,280,780,165.2296603019996,62.69021249055177,59,196,254,509,789
2019-12-03,7.655958699287267e+20,1003520158011,174,346,1193,190.09556517556518,63.573964646464646,96,271,270,637,983
2019-12-04,5.6384706644628124e+20,738895219286,122,240,816,143.32667987567987,42.51471495633996,81,196,192,469,709
2019-12-05,5.772428899093243e+20,756266217197,187,368,1621,152.56595454545453,45.60153282828283,82,185,213,480,848
2019-12-06,5.557728683971782e+20,727948335644,156,246,914,145.23886544011543,41.735267556517556,80,209,173,462,708
2019-12-07,1.8048986789354688e+20,236357383975,92,160,605,46.15826515151515,13.913916486291486,26,57,67,150,310
2019-12-08,1.769376015609313e+20,231643952749,302,284,1028,50.20891293891294,8.123072691197692,35,57,55,147,431
2019-12-09,4.635583677458322e+20,606722392418,103,261,851,118.92198773448773,37.10500962000962,61,154,170,385,646
2019-12-10,4.817661635117862e+19,63039599383,14,12,40,11.44108225108225,3.8128246753246753,7,16,17,40,52
2019-12-11,5.313061655672468e+20,695049484671,168,303,954,131.60716892135642,33.870540313852814,62,187,192,441,744
2019-12-12,4.796395021858251e+20,627311288304,132,262,985,130.46972162097163,39.85282647907648,53,168,177,398,660
2019-12-13,4.412070860186631e+20,576905567082,94,233,698,115.05417415917415,38.53479115791616,50,157,159,366,599
2019-12-14,1.712226619954858e+20,223837230112,58,171,477,40.98386544011544,11.027160894660895,19,70,53,142,313
2019-12-15,1.616338997442405e+20,211240411248,48,99,253,33.888676046176045,9.799354256854256,19,73,42,134,233
2019-12-16,6.16571125570591e+20,805596683467,261,443,1368,167.76729666563594,54.830741110080396,72,197,242,511,954
2019-12-17,7.965884383919498e+20,1040552566551,254,502,2289,212.92774591149592,84.21336640211639,80,269,311,660,1162
2019-12-18,6.990215299517477e+20,912895169970,165,365,1307,202.4376719061362,68.33213324572253,76,224,279,579,944
2019-12-19,5.398195099836547e+20,704812233987,242,369,1746,149.88259992784992,44.55945815295815,53,194,200,447,816
2019-12-20,5.484455047161436e+20,715890676221,158,298,1046,149.44002236652236,45.025709355459355,65,190,199,454,752
2019-12-21,1.921281012320734e+20,250731669796,82,128,317,53.70925992063492,17.65855889249639,14,75,70,159,287
2019-12-22,1.7164072371944266e+20,223936903796,70,173,707,45.93040584415584,17.72149621212121,15,52,75,142,315
2019-12-23,3.2041721354627226e+20,417934684919,81,188,465,92.01895166341595,14.552862682951968,57,98,110,265,453
2019-12-24,2.8905963098976318e+20,376948745318,71,161,568,75.4617697778412,25.015357915893627,32,93,114,239,400
2019-12-25,9.557388536156843e+19,124604552911,15,60,119,25.5660101010101,8.164608585858586,13,36,30,79,139
2019-12-26,1.5370120601419472e+21,2003272648633,570,710,4382,428.8330982952233,144.7674037952788,173,556,541,1270,1980
2019-12-27,1.1754310360076559e+21,1531703357341,431,642,3642,326.55623773448775,116.78602958152958,117,402,452,971,1613
2019-12-28,2.3491236598991176e+20,306041457501,144,503,1393,65.54331204906205,21.729724567099566,27,82,85,194,697
2019-12-29,1.8411205288388877e+20,239798650116,62,293,580,50.2663183020683,18.14045779220779,13,56,83,152,445
2019-12-30,6.252207921717614e+20,814103099561,142,255,1334,168.35624975949975,57.43029154641654,62,211,243,516,771
2019-12-31,5.829812108678126e+20,758923174515,160,234,1037,159.31559163059163,51.07614538239538,79,181,221,481,715
2020-01-01,7.272935189113115e+18,9467012719,0,1,6,1.4865079365079363,0.8428571428571427,0,2,4,6,7
