date,tweet_id,post_date,comment_num,retweet_num,like_num,Subjuctivity,Polarity,Class_sentiment_negative,Class_sentiment_neutral,Class_sentiment_positive,tweet_count,total_count_tweet
2015-01-01,5.175965551514769e+19,133490951098,23,42,87,30.276262626262625,12.192171717171718,15,44,35,94,136
2015-01-02,1.1130771498502301e+20,286882492028,43,51,136,58.11785714285714,24.628968253968253,25,102,75,202,253
2015-01-03,4.962337416175154e+19,127826282034,10,25,89,19.596165223665224,6.0154329004329,6,58,26,90,115
2015-01-04,6.620679349529955e+19,170445126534,11,35,75,21.760569985569987,7.2272727272727275,9,81,30,120,155
2015-01-05,1.5238213713623905e+20,392049185482,23,80,201,78.2108676046176,36.70006313131313,17,148,111,276,356
2015-01-06,1.2982794790152857e+20,333829613792,22,36,155,57.58534451659452,17.047315115440114,20,150,65,235,271
2015-01-07,1.4152032702951352e+20,363682828670,13,61,211,59.85205627705628,27.470310245310245,9,158,89,256,317
2015-01-08,1.338718097281892e+20,343815590400,25,45,217,71.52362651237651,16.8834613997114,28,130,84,242,287
2015-01-09,1.4558520760769328e+20,373673816548,22,57,228,67.74058802308802,22.50584505772006,24,148,91,263,320
2015-01-10,5.428012284250081e+19,139247217227,19,61,106,18.959518398268397,3.699897186147186,10,67,21,98,159
2015-01-11,3.4361023939059577e+19,88100074899,7,12,48,19.034772727272728,12.535681818181818,3,25,34,62,74
2015-01-12,2.2352549295321783e+20,572693125011,71,186,365,118.56411736411737,33.99587812650313,48,208,147,403,589
2015-01-13,2.991737885763554e+20,766010640639,126,341,518,169.66732924482923,46.92022005772006,62,276,201,539,880
2015-01-14,4.6926446266374305e+20,1200946919579,167,335,619,259.79153217153214,46.92634111259111,155,425,265,845,1180
2015-01-15,2.0172049747173166e+20,515941009999,42,70,149,94.45445887445888,29.869011544011542,39,216,108,363,433
2015-01-16,2.1075623796286534e+20,538716658001,24,46,118,75.10242544492544,21.600084776334775,25,267,87,379,425
2015-01-17,6.565930087175875e+19,167736924165,19,34,80,27.9604531024531,8.092981240981242,10,73,35,118,152
2015-01-18,7.293740748631538e+19,186227014666,10,83,166,36.14132034632035,16.054729437229437,8,81,42,131,214
2015-01-19,5.070356689595043e+19,129372655027,9,29,72,27.64027777777778,10.25,8,52,31,91,120
2015-01-20,1.5109509681308346e+20,385298156294,26,42,89,77.92649544899545,32.43753191253192,25,140,106,271,313
2015-01-21,1.6457792236137926e+20,419444751775,50,128,243,82.71996401746402,25.19862073112073,26,158,111,295,423
2015-01-22,2.3280822389147412e+20,592949990157,29,40,81,57.7771645021645,18.086219336219337,18,314,85,417,457
2015-01-23,1.932892348424807e+20,492020645788,17,42,114,69.05542929292929,25.180934343434345,26,232,88,346,388
2015-01-24,5.7012385179133936e+19,145053979229,17,21,68,24.92727272727273,10.590205627705627,4,65,33,102,123
2015-01-25,4.64231171145174e+19,118041436475,4,10,30,20.802777777777777,9.768055555555556,2,50,31,83,93
2015-01-26,1.2537681658189211e+20,318591196674,30,27,124,72.2599025974026,29.015638528138528,17,108,99,224,251
2015-01-27,1.3217798719588064e+20,335678741803,26,41,110,64.88623376623377,18.968102453102453,30,134,72,236,277
2015-01-28,1.2665747940025503e+20,321474200435,11,25,93,69.75321428571428,9.706244588744589,30,121,75,226,251
2015-01-29,1.5646699094172133e+20,396889595446,26,55,119,89.6239145021645,30.116974747474746,28,141,110,279,334
2015-01-30,1.3636089605650616e+20,345697869798,21,42,105,69.66827200577201,18.482274531024533,23,139,81,243,285
2015-01-31,5.39048139431132e+19,136580066668,3,17,44,23.961796536796538,6.294372294372295,6,66,24,96,113
2015-02-01,6.011960445084561e+19,152238972910,4,24,57,26.740804473304472,9.967551406926408,6,68,33,107,131
2015-02-02,1.2763466332772052e+20,322996014206,25,70,147,63.04904918229918,17.406146825396824,30,129,68,227,297
2015-02-03,1.5809843586740296e+20,399856232182,36,70,179,66.36199675324676,19.250761183261183,32,169,80,281,351
2015-02-04,1.6045127051754904e+20,405572531571,16,23,83,66.71298701298701,18.144682539682538,22,189,74,285,308
2015-02-05,1.4815942378926752e+20,374287557505,22,65,140,56.36790404040404,12.669641053391054,27,176,60,263,328
2015-02-06,1.6234370426665684e+20,409890227846,31,956,162,93.37618326118326,37.5197113997114,22,147,119,288,1244
2015-02-07,7.501566110878353e+19,189300178897,13,40,122,39.277272727272724,15.521872294372294,12,75,46,133,173
2015-02-08,8.917709952502799e+19,224897403271,23,61,140,41.67039141414141,8.367992424242425,22,93,43,158,219
2015-02-09,1.649133577654055e+20,415658220882,69,105,244,71.51238095238095,21.708102453102452,32,185,75,292,397
2015-02-10,2.7241809773742608e+20,686167993336,85,207,340,141.05446608946608,41.319155844155844,59,268,155,482,689
2015-02-11,6.696365406891635e+20,1685634401944,368,779,1045,354.8063676046176,59.251142316017315,219,583,382,1184,1963
2015-02-12,1.0151109157547184e+21,2554191245795,506,781,1178,554.9888131313131,84.72293831168831,331,890,573,1794,2575
2015-02-13,2.8706833637518613e+20,721881756755,107,196,315,136.24273424723424,34.38456854256854,68,280,159,507,703
2015-02-14,2.2661058494812704e+20,569562163334,126,189,261,125.72046386483886,31.19282196969697,51,208,141,400,589
2015-02-15,1.7916189982211218e+20,449987377415,79,122,218,56.31628121878122,14.714799506049506,21,225,70,316,438
2015-02-16,1.4977158739956246e+20,375960762225,101,135,247,72.01317099567099,15.238434343434344,35,150,79,264,399
2015-02-17,2.3559551697824157e+20,591036862670,132,142,285,128.7058189033189,35.10201118326118,44,215,156,415,557
2015-02-18,1.3632768944082484e+20,341823447805,40,63,126,81.00513708513708,25.678782467532468,21,112,107,240,303
2015-02-19,2.3305802976148315e+20,583987703707,94,132,246,127.2859139009139,33.931454725829724,51,202,157,410,542
2015-02-20,2.6106836613362483e+20,653818802042,90,178,300,123.9665076960077,33.6673823953824,54,245,160,459,637
2015-02-21,1.0528787518127192e+20,263537055807,40,52,134,48.80800865800866,18.115728715728714,14,104,67,185,237
2015-02-22,8.599074279386e+19,215115871810,37,46,154,41.24262746512746,14.016601731601732,15,83,53,151,197
2015-02-23,2.211160010698248e+20,552786132766,115,270,312,118.59005411255411,37.95741883116883,52,196,140,388,658
2015-02-24,2.1269603003707766e+20,531446130624,113,174,455,120.7668253968254,39.31540764790765,49,172,152,373,547
2015-02-25,1.9856950024418856e+20,495857229111,55,34,216,93.09925685425685,21.377884199134197,53,192,103,348,382
2015-02-26,2.637802806226919e+20,658331877755,126,224,352,133.25071248196247,33.26460858585859,77,236,149,462,686
2015-02-27,1.725258940967512e+20,430361540722,46,62,157,74.86190957190956,12.552344877344877,39,182,81,302,364
2015-02-28,6.402428816934015e+19,159614096924,13,51,77,29.815595238095238,7.117467532467533,12,68,32,112,163
2015-03-01,5.54828783077164e+19,138245141503,10,41,70,20.092658730158732,6.502083333333334,8,66,23,97,138
2015-03-02,2.3869798390484625e+20,594354218377,103,185,307,103.54237399505256,26.059662956091525,39,259,119,417,602
2015-03-03,2.050448409229701e+20,510289420374,59,165,159,80.59993867243867,18.573333333333334,50,222,86,358,523
2015-03-04,1.9715459342499807e+20,490364549147,57,76,142,74.6025937950938,18.345220057720056,45,208,91,344,420
2015-03-05,1.8810478869035716e+20,467585547962,39,60,135,85.02573953823953,18.967974386724386,39,194,95,328,388
2015-03-06,2.0831511990661146e+20,517513290524,54,124,170,82.79159632034631,15.19525432900433,51,226,86,363,487
2015-03-07,1.1598124583626116e+20,287996748618,21,114,126,39.239992784992786,12.53845238095238,13,140,49,202,316
2015-03-08,7.986192950762509e+19,198188629168,17,27,53,27.59617257742258,9.126100288600288,12,89,38,139,166
2015-03-09,2.7136644668651962e+20,673028910421,74,148,241,115.90590007215008,17.003277417027416,71,285,116,472,620
2015-03-10,2.2493424944194653e+20,557562979031,47,80,170,101.19306277056278,29.062907647907647,43,226,122,391,471
2015-03-11,1.9457076247938617e+20,482015505986,65,113,178,91.40250631313131,22.044554473304473,45,182,111,338,451
2015-03-12,1.5609952337065473e+20,386491304550,33,58,120,63.65710858585859,14.975142496392497,34,166,71,271,329
2015-03-13,2.397729716831038e+20,593321680457,59,155,227,106.78304473304473,30.823897005772007,60,242,114,416,571
2015-03-14,1.0496383807544218e+20,259593294420,12,72,80,37.526338383838386,10.637803030303031,17,123,42,182,254
2015-03-15,1.0329912812890563e+20,255329891725,20,121,157,46.30954184704185,17.968371212121212,12,101,66,179,300
2015-03-16,3.239745902987585e+20,800277981990,257,924,458,158.64240175565175,39.779631673881674,76,292,193,561,1485
2015-03-17,1.6700572104590872e+20,412290574244,50,140,266,72.21549783549783,23.728134920634922,33,172,84,289,429
2015-03-18,1.9312530301561458e+20,476515541697,54,354,314,107.97033369408369,34.45655844155844,35,152,147,334,688
2015-03-19,4.790616500003177e+20,1181372556499,145,393,619,225.67599206349206,58.94006192881193,96,463,269,828,1221
2015-03-20,2.4082832953977202e+20,593573297389,38,139,209,95.90286465848966,29.00540764790765,49,261,106,416,555
2015-03-21,1.1990853295141475e+20,295377261697,13,79,85,48.58417693417693,10.091402347652348,29,130,48,207,286
2015-03-22,8.578506911634771e+19,211200330459,41,91,152,44.49602813852814,11.921883116883118,19,80,49,148,239
2015-03-23,1.2063964018070228e+20,296840406217,34,65,112,45.70782731157731,11.823845182595184,27,134,47,208,273
2015-03-24,1.5495703098566066e+20,381063573248,30,75,155,60.2864905002405,12.450283189033188,31,171,65,267,342
2015-03-25,2.1776997180941084e+20,535233522565,38,162,240,92.06392436267436,24.35870670995671,56,208,111,375,537
2015-03-26,1.6561436064066922e+20,406803508182,41,62,132,77.11597763347763,19.176112914862916,49,148,88,285,347
2015-03-27,3.0411422924256444e+20,746567173912,141,179,391,173.30900613275614,32.45014971139971,94,253,176,523,702
2015-03-28,9.367280682853517e+19,229835768345,64,53,106,56.35782106782107,14.686506132756133,30,66,65,161,214
2015-03-29,9.547850851941818e+19,234132786098,27,150,145,46.92211915069058,12.221936198721913,18,94,52,164,314
2015-03-30,5.284067829777002e+20,1294955315940,184,657,767,310.4273328523328,95.32269119769119,124,356,427,907,1564
2015-03-31,2.9960831724875776e+20,733893365994,135,351,426,142.82653762903763,41.28877344877345,58,263,193,514,865
2015-04-01,2.263172685602175e+20,554026211575,93,983,429,112.94607443482444,30.380084776334776,54,202,132,388,1371
2015-04-02,2.3870130028030853e+20,584044329272,72,122,208,122.94837842712842,39.15289772727272,46,211,152,409,531
2015-04-03,1.4424507433744844e+20,352732944285,32,119,163,85.85312049062048,28.79674963924964,32,112,103,247,366
2015-04-04,9.349256674336852e+19,228503960781,13,53,58,40.49269397269397,13.534605810855812,11,104,45,160,213
2015-04-05,8.595216541950217e+19,209951334349,16,77,55,48.27593795093795,10.95849567099567,17,89,41,147,224
2015-04-06,5.072801537331407e+20,1238364936040,147,473,698,243.5752644022644,79.62489321789322,110,457,300,867,1340
2015-04-07,1.9729209269143562e+20,481375486695,57,92,225,95.23719336219337,23.67128787878788,45,178,114,337,429
2015-04-08,3.4855912550508003e+20,849959781058,88,287,461,193.40003908128907,21.66559343434343,111,276,208,595,882
2015-04-09,2.075005770569051e+20,505719573598,56,105,207,106.37733441558441,25.378166125541124,54,173,127,354,459
2015-04-10,1.460453890370191e+20,355739842695,34,89,135,68.03941558441558,16.16362554112554,38,133,78,249,338
2015-04-11,6.983598378291475e+19,170021557949,12,764,356,38.8262543012543,4.30875541125541,24,62,33,119,883
2015-04-12,8.515407921859546e+19,207183385825,21,70,165,34.50328282828283,2.656818181818182,16,98,31,145,215
2015-04-13,1.2163604269067787e+20,295789132117,35,87,148,64.81988455988456,15.320809283309284,34,105,68,207,294
2015-04-14,1.9402842237958167e+20,471575522244,32,74,136,99.41682178932179,21.57060515873016,39,185,106,330,404
2015-04-15,1.5414276022623384e+20,374425261097,10,55,96,52.00419191919192,14.260963203463202,20,183,59,262,317
2015-04-16,1.0831887712959513e+20,262970868024,13,64,117,64.73854256854257,16.535483405483404,21,88,75,184,248
2015-04-17,1.496226346077425e+20,363036899377,13,41,110,68.99930856180856,6.92974446849447,52,145,57,254,295
2015-04-18,6.483486422660903e+19,157229683361,9,20,52,17.837402597402598,6.185252525252525,1,84,25,110,130
2015-04-19,6.310646126039163e+19,152951095066,5,28,50,25.69128787878788,7.033279220779221,5,74,28,107,135
2015-04-20,1.9652299517675166e+20,476036779665,60,164,350,92.83038961038962,27.365579004329003,28,188,117,333,497
2015-04-21,2.409340358208918e+20,583287819937,65,103,242,126.3827929015429,36.48760184260184,56,215,137,408,511
2015-04-22,3.805338086525516e+20,920736053323,143,335,656,180.88441594516596,55.73438005050505,81,338,225,644,979
2015-04-23,2.1402762236441782e+20,517586422262,54,92,233,112.02473737373737,34.5417886002886,51,170,141,362,454
2015-04-24,2.4374990457117884e+20,589114515263,33,80,220,123.3951984126984,41.43979888167388,44,214,154,412,492
2015-04-25,8.169157258170026e+19,197336015091,20,106,151,34.90746620971621,9.79464898989899,16,80,42,138,244
2015-04-26,8.470067652980053e+19,204497616250,18,32,78,46.43467171717172,16.250032467532467,15,66,62,143,175
2015-04-27,4.3030919189077e+20,1038287897360,122,209,493,241.14879329004327,75.23246933621934,96,323,307,726,935
2015-04-28,2.4255127059311447e+20,584962233735,30,176,256,109.60766955266955,29.24688492063492,55,226,128,409,585
2015-04-29,2.124455160952975e+20,512053878835,34,66,152,104.33564574314575,29.235609668109667,39,192,127,358,424
2015-04-30,3.5033623078341666e+20,843939301122,62,284,401,127.1297077922078,32.41223124098124,57,369,164,590,874
2015-05-01,7.254099727779223e+20,1746618718421,235,691,940,346.060073953824,91.56306427368928,178,619,424,1221,1912
2015-05-02,1.8250791137755e+20,439185613964,61,156,303,76.72596861471861,29.44852994227994,19,186,102,307,463
2015-05-03,1.6655308794416517e+19,40058314334,14,72,79,3.9583333333333335,0.9833333333333334,2,22,4,28,100
2015-05-04,2.7380064797987553e+20,658143249555,64,161,319,105.46274350649351,34.16034271284271,33,293,134,460,621
2015-05-05,3.627098829349287e+20,871377274167,81,314,510,169.27073569023568,49.36351695526695,72,320,217,609,923
2015-05-06,6.133038913146712e+20,1472434230736,235,708,933,286.05812002812,68.65515949328449,144,547,338,1029,1737
2015-05-07,5.79052131988749e+20,1389515546435,121,342,503,214.4744715007215,35.036758658008665,167,586,218,971,1313
2015-05-08,2.4524456840808628e+20,588182035904,46,119,255,86.27002525252524,27.863609307359308,29,270,112,411,530
2015-05-09,2.465672814080233e+20,591075065220,22,103,160,83.52779553779554,14.906364746364746,30,305,78,413,516
2015-05-10,7.886053816162663e+19,188928034044,5,46,96,31.461969696969696,13.919794372294373,10,82,40,132,178
2015-05-11,2.462757929096135e+20,589716733953,58,117,294,107.64960497835497,32.8020183982684,42,242,128,412,529
2015-05-12,8.01601615944985e+19,191815558360,26,36,88,33.895306637806634,9.68726911976912,12,77,45,134,170
2015-05-13,2.016975866941444e+20,482425838311,34,121,244,93.27233405483406,31.878405483405484,41,183,113,337,458
2015-05-14,2.449245850282049e+20,585528075974,36,80,185,87.00083092833093,29.86232142857143,27,285,97,409,489
2015-05-15,2.5048026242603952e+20,598452167454,41,582,227,90.95196248196248,20.73524531024531,36,276,106,418,1000
2015-05-16,1.5888107970746856e+20,379421469419,14,44,131,35.182382154882156,7.999520202020202,14,210,41,265,309
2015-05-17,1.2178254754150493e+20,290668721699,8,76,141,28.174271284271285,6.586948051948052,8,166,29,203,279
2015-05-18,2.6112914168726838e+20,622901252684,39,144,205,88.21041486291486,3.7599320586820584,65,294,76,435,579
2015-05-19,9.251178048170266e+19,220537113270,11,8,38,25.39981277056277,6.8127521645021645,15,111,28,154,162
2015-05-20,2.1575997526809952e+20,514132942447,16,34,88,73.81901334776335,19.596226551226554,30,255,74,359,393
2015-05-21,2.9467391304917503e+20,701784872970,24,101,199,88.04661976911977,8.857555916305918,82,328,80,490,591
2015-05-22,2.382877173788431e+20,567190868754,25,50,122,80.64113636363636,22.00397186147186,32,272,92,396,446
2015-05-23,6.381745810958931e+19,151831774944,9,17,37,25.88017676767677,6.25,8,70,28,106,123
2015-05-24,2.2891642327404577e+19,54433521855,5,9,19,14.041222041847043,3.027762445887446,5,20,13,38,47
2015-05-25,1.0549635406738768e+20,250698411317,9,47,101,31.646840104340104,6.890844155844156,12,127,36,175,222
2015-05-26,1.7069632515442668e+20,405437472990,30,50,158,68.04582972582972,9.129918831168832,30,187,66,283,333
2015-05-27,1.629684269894854e+20,386840143822,31,94,141,82.21931457431457,18.923722943722943,47,142,81,270,364
2015-05-28,2.4458784141709804e+20,580292450144,81,139,252,99.90221981721982,31.067507215007215,33,237,135,405,544
2015-05-29,2.277987016562983e+20,540202228023,45,46,153,68.84660173160172,21.84582611832612,25,275,77,377,423
2015-05-30,1.4027844357452775e+20,332454701198,10,39,77,53.64310606060606,12.393896103896104,15,154,63,232,271
2015-05-31,1.500344763502965e+20,355402080253,15,73,97,62.91783383283383,19.79835137085137,6,159,83,248,321
2015-06-01,1.8161275278451e+20,429950346709,37,88,171,76.38124218374219,26.03724025974026,21,192,87,300,388
2015-06-02,1.8353214733005144e+20,434274470958,17,57,106,71.90291125541125,20.61656204906205,14,212,77,303,360
2015-06-03,1.6970471673509344e+20,401334550195,18,73,119,66.98128968253968,8.014696969696969,24,193,63,280,353
2015-06-04,1.7647399743013854e+20,417125657191,29,55,95,60.40198773448773,16.026417748917748,14,208,69,291,346
2015-06-05,2.2331037973999727e+20,527532613925,27,89,172,90.36284992784992,20.168354978354976,78,199,91,368,457
2015-06-06,4.6750374637845594e+19,110386450904,11,17,75,27.906542207792207,1.747516233766234,12,47,18,77,94
2015-06-07,6.014863597261945e+19,141935214763,22,208,207,22.540757575757574,7.435108225108225,6,66,27,99,307
2015-06-08,3.1793243672162927e+20,749861691287,45,117,295,147.14415145502645,38.52869426406926,50,283,190,523,640
2015-06-09,2.9562820026300655e+20,696857052876,55,179,315,116.83265130702631,20.71314514189514,55,305,126,486,665
2015-06-10,2.6961410835047665e+20,635234906171,40,126,210,96.12156565656565,18.980473184223182,42,290,111,443,569
2015-06-11,1.9000356305895657e+20,447416891466,10,72,126,69.00282828282828,10.82869227994228,31,207,74,312,384
2015-06-12,2.5348885764210737e+20,596591802502,13,40,60,65.32126262626262,4.948064574314575,35,315,66,416,456
2015-06-13,3.2312887828464615e+19,76012246433,5,9,18,12.542370129870129,3.3383658008658004,5,29,19,53,62
2015-06-14,8.113849545562063e+19,190759976362,10,79,98,24.76702922077922,2.198158369408369,8,102,23,133,212
2015-06-15,2.0816419414529468e+20,489122937567,30,132,195,66.09151154401154,10.333804112554112,36,237,68,341,473
2015-06-16,1.7408089711616993e+20,408822087772,17,68,114,50.06791097791098,15.287064602064602,17,208,60,285,353
2015-06-17,2.8053140444114754e+20,658459151964,30,84,191,106.70146825396824,32.66702561327561,42,275,142,459,543
2015-06-18,2.68458946353888e+20,629804154208,20,49,74,75.30850649350648,19.763376623376622,29,315,95,439,488
2015-06-19,1.7744494214932637e+20,416068313480,25,92,116,61.468229918229916,13.962103174603174,22,197,71,290,382
2015-06-20,1.108143946514925e+20,259699340839,4,49,60,28.674227994227994,9.867474747474747,6,139,36,181,230
2015-06-21,1.151644992177674e+20,269758331400,10,45,90,28.58788961038961,7.00025974025974,9,142,37,188,233
2015-06-22,2.660341244585029e+20,622781856730,44,114,176,99.37444985569985,24.61176406926407,47,274,113,434,548
2015-06-23,2.2510070278815626e+20,526670625227,40,85,160,106.0039199134199,32.97535317460317,33,190,144,367,452
2015-06-24,2.037442775100126e+20,476469632568,28,85,167,78.57617063492063,22.47596681096681,25,209,98,332,417
2015-06-25,2.505413646846361e+20,585578385631,41,105,235,89.37170634920635,21.155470779220778,37,257,114,408,513
2015-06-26,1.9722580856912957e+20,460738323750,27,48,77,87.42541967291967,35.995252525252525,12,187,122,321,369
2015-06-27,1.2848928752050754e+20,300000742966,2,10,31,80.43412837162838,29.14811854811855,7,94,108,209,219
2015-06-28,1.6609682808336083e+20,387586012771,11,29,70,95.6295238095238,33.77801046176046,14,128,128,270,299
2015-06-29,2.7019656494403358e+20,630218434743,32,73,147,104.88178391053391,38.156473665223665,26,275,138,439,512
2015-06-30,2.3649626258053618e+20,551297732960,31,56,112,78.04101911976912,22.193522727272725,37,246,101,384,440
2015-07-01,1.6822748433446686e+20,391960505727,13,72,152,69.10548729048729,15.941722582972583,28,160,85,273,345
2015-07-02,4.131271827244064e+20,962016628578,117,312,445,170.56483092833093,52.035440836940836,69,371,230,670,982
2015-07-03,1.52382735506409e+20,354673113902,12,62,103,56.89632756132756,10.02843795093795,20,174,53,247,309
2015-07-04,1.339563421591408e+20,311614870150,18,61,93,46.06583333333333,18.705,11,149,57,217,278
2015-07-05,6.423589858264984e+19,149353868982,7,25,41,25.729357864357862,5.945497835497835,7,68,29,104,129
2015-07-06,1.1124893376675961e+20,258514108065,37,96,137,49.990006974506976,16.14649494949495,13,106,61,180,276
2015-07-07,3.147723044527821e+20,731064567413,67,113,231,133.53564574314575,35.162101370851374,52,304,153,509,622
2015-07-08,2.4627086692301288e+20,571671869884,77,211,305,117.1654074074074,30.989065295815294,49,197,152,398,609
2015-07-09,1.485902684107886e+20,344747074465,18,59,118,75.5394769119769,23.116060606060607,38,113,89,240,299
2015-07-10,2.1683001372843403e+20,502788544733,25,64,162,68.24679834054834,17.819585137085138,29,243,78,350,414
2015-07-11,1.1652866893556312e+20,270083574815,5,20,43,32.97596681096681,7.34502886002886,13,145,30,188,208
2015-07-12,1.2032157178474643e+20,278720883163,13,11,39,38.75568542568542,5.212204184704186,21,125,48,194,205
2015-07-13,9.246740170309624e+19,214082357684,15,34,98,46.430950577200576,13.95522546897547,25,69,55,149,183
2015-07-14,1.6579311276745133e+20,383647096475,17,340,86,40.182397186147185,8.578638167388169,26,196,45,267,607
2015-07-15,1.8452683176688884e+20,426778612362,24,316,312,65.23247835497835,12.247337662337664,27,193,77,297,613
2015-07-16,1.8339473430562072e+20,423931029344,24,107,160,65.55700937950938,23.493170995670994,17,182,96,295,402
2015-07-17,3.483581968883561e+20,804802651844,112,285,496,142.75098965848966,42.64871272246272,58,313,189,560,845
2015-07-18,9.086490903130545e+19,209833788726,21,42,77,41.1324531024531,15.24760101010101,16,72,58,146,188
2015-07-19,4.2971011302767034e+19,99174700675,5,29,50,23.701147186147185,6.759891774891774,7,32,30,69,98
2015-07-20,2.679438575335159e+20,618081832686,51,129,265,104.73477489177489,29.182310245310244,38,262,130,430,559
2015-07-21,3.4665705033669024e+20,799241727001,118,243,359,159.9079743867244,32.651877705627705,96,294,166,556,799
2015-07-22,1.965122697392747e+20,452835192987,35,64,135,71.46556277056277,19.326626984126985,27,202,86,315,379
2015-07-23,8.115777464716427e+19,186898067953,20,7,38,36.34129148629148,-4.676176046176043,56,52,22,130,137
2015-07-24,1.473989429780146e+20,339307700449,23,51,87,52.5211537999038,15.657610028860029,22,159,55,236,287
2015-07-25,1.2497737095828501e+20,287563922036,4,15,69,31.04616883116883,4.48232683982684,14,157,29,200,215
2015-07-26,5.4401305405589996e+19,125098924685,12,38,66,21.504166666666666,11.396969696969697,7,53,27,87,125
2015-07-27,1.2702108381259363e+20,291917686065,46,79,221,56.96066378066378,15.315111832611832,35,103,65,203,282
2015-07-28,2.0471075800772044e+20,470255884595,42,85,167,77.64835678210677,25.67367303992304,26,202,99,327,412
2015-07-29,1.0587421318247704e+20,243055490102,44,84,154,41.164061216561215,13.19573384948385,20,88,61,169,253
2015-07-30,6.079317303441698e+20,1395112144254,46,150,220,120.12342352092348,23.774953102453104,28,847,95,970,1120
2015-07-31,4.959752279174122e+20,1137718173676,25,121,191,108.97445887445885,21.134244227994227,28,666,97,791,912
2015-08-01,1.0666496870991013e+20,244532855887,7,31,117,28.35034632034632,11.314588744588743,3,120,47,170,201
2015-08-02,1.5319008398140378e+20,350999095851,7,22,83,51.08270923520924,9.451093073593073,11,168,65,244,266
2015-08-03,2.2615009304589396e+20,517898974544,30,101,200,61.31987133237133,9.211901154401154,43,261,56,360,461
2015-08-04,1.451968445997132e+20,332338504409,33,87,117,46.9775505050505,17.60540404040404,19,147,65,231,318
2015-08-05,7.340416335739096e+20,1679079578109,283,750,1062,335.0682938034188,97.18149453324453,176,573,418,1167,1917
2015-08-06,2.9138071598452326e+20,666201169316,70,242,382,146.95019216894218,25.918229964479966,99,205,159,463,705
2015-08-07,3.507045490998781e+20,801495560884,26,101,168,94.80162878787878,23.00073593073593,34,418,105,557,658
2015-08-08,8.063119427864045e+19,184194851459,12,20,31,29.018715728715726,8.047662337662336,10,81,37,128,148
2015-08-09,9.140274171600296e+19,208673183059,23,65,146,33.95892255892256,2.8704545454545456,34,82,29,145,210
2015-08-10,2.1950073298236198e+20,500847623878,56,197,265,85.80982864357864,9.8256259018759,62,194,92,348,545
2015-08-11,1.968982401212257e+20,449060710576,22,118,193,56.05848124098124,16.803802308802307,29,214,69,312,430
2015-08-12,1.8312415298718594e+20,417422342860,53,182,277,54.46133352758353,11.467458513708513,31,201,58,290,472
2015-08-13,4.03737292661178e+20,919824020116,123,305,718,151.07656158656158,28.340912698412698,106,347,186,639,944
2015-08-14,3.129163380884603e+20,712578380905,36,1057,467,109.40277326839826,19.02733134920635,68,292,135,495,1552
2015-08-15,1.2587201483526822e+20,286488386782,6,42,97,32.622034632034634,1.0642207792207792,17,152,30,199,241
2015-08-16,7.024941769051793e+19,159809448479,8,51,80,22.46181818181818,6.131688311688311,10,75,26,111,162
2015-08-17,4.660990707143293e+20,1059709219136,155,442,1344,224.8531948051948,52.22201623376623,104,361,271,736,1178
2015-08-18,2.4141201579196452e+20,548603234934,31,72,186,78.73770202020202,20.102978595478593,36,254,91,381,453
2015-08-19,1.8005690392621233e+20,408958043850,40,242,324,63.182772366522364,20.690070346320343,29,173,82,284,526
2015-08-20,1.700105087884466e+20,385941437021,48,169,242,71.93630711880712,20.30376262626263,34,150,84,268,437
2015-08-21,1.599505710919623e+20,362921601376,36,140,172,61.235950577200576,14.270594035594035,41,148,63,252,392
2015-08-22,5.27064145401281e+19,119539491319,20,78,113,12.538614718614719,5.7968290043290045,6,57,20,83,161
2015-08-23,4.1939390126869406e+19,95062238099,9,42,59,11.94845238095238,4.38547619047619,6,44,16,66,108
2015-08-24,1.945574130120365e+20,440769604057,46,125,223,87.12866161616162,27.411423160173157,38,161,107,306,431
2015-08-25,1.7177004763223903e+20,388938613707,41,56,177,59.124170274170275,10.000117243867244,35,174,61,270,326
2015-08-26,2.297820210266448e+20,520053728626,20,86,186,79.26897546897547,23.20500541125541,29,229,103,361,447
2015-08-27,3.4265380906239276e+20,775088250366,93,265,445,129.4633651996152,48.24766414141414,62,324,152,538,803
2015-08-28,3.001480443371435e+20,678602143078,67,174,285,95.28711399711399,24.085753968253968,41,328,102,471,645
2015-08-29,1.5811536419894873e+20,357328714055,17,42,117,56.87999278499279,13.594962121212122,19,171,58,248,290
2015-08-30,1.1929351890543632e+20,269453931441,13,48,109,36.759826839826836,3.413852813852814,43,114,30,187,235
2015-08-31,2.1575707215095837e+20,487066715838,51,77,189,84.06025974025974,16.642003066378066,38,216,84,338,415
2015-09-01,1.769241795325259e+20,399189299334,40,94,181,71.22051587301587,14.986244588744588,48,144,85,277,371
2015-09-02,1.8725186171850532e+20,422272970228,52,124,189,76.08761183261183,33.54958152958153,27,157,109,293,417
2015-09-03,2.0589309267145137e+20,464093600285,34,119,138,84.63115606615607,29.866204674954673,36,174,112,322,441
2015-09-04,1.695446618269558e+20,381963865523,14,124,91,59.862339466089466,13.32263437950938,32,178,55,265,389
2015-09-05,4.672999238969379e+19,105226251498,6,19,20,13.748406685906685,5.654410173160173,5,47,21,73,92
2015-09-06,4.611818692468115e+19,103791550739,4,45,51,16.410800865800866,4.165037878787879,8,44,20,72,117
2015-09-07,4.293809538559159e+19,96589182962,21,115,235,8.726569264069264,6.684577922077922,2,50,15,67,182
2015-09-08,1.590322152904458e+20,357547308393,21,72,122,59.60488365800865,19.178568722943723,15,143,90,248,320
2015-09-09,1.9632763085280497e+20,441191656879,26,92,165,69.78384199134199,14.204388528138526,27,200,79,306,398
2015-09-10,1.4059134045540698e+20,315774446968,18,102,100,51.5761075036075,12.74762085137085,29,127,63,219,321
2015-09-11,1.9397702563024362e+20,435475889022,11,49,74,52.141845238095236,14.234940476190475,19,220,63,302,351
2015-09-12,5.71938856251729e+19,128342397643,10,18,49,16.34776455026455,3.7629437229437226,7,64,18,89,107
2015-09-13,4.243973338660836e+19,95181529222,6,22,24,13.741753246753246,3.534437229437229,8,38,20,66,88
2015-09-14,1.2611170918477233e+20,282679029445,22,70,125,45.281018518518515,14.045912698412698,16,126,54,196,266
2015-09-15,1.8862543309452077e+20,422600455171,24,75,132,70.17965728715728,17.796246392496393,40,150,103,293,368
2015-09-16,1.7521297846760715e+20,392337142332,30,88,159,67.72891895141895,8.36541366041366,37,160,75,272,360
2015-09-17,2.4683994232922102e+20,552475023419,24,58,120,78.82606421356421,23.11853354978355,51,235,97,383,441
2015-09-18,1.973279467119501e+20,441430150762,25,46,108,55.25992424242424,14.157031024531024,23,214,69,306,352
2015-09-19,1.4323619220909605e+20,320271533685,4,36,43,36.96576118326118,6.468660413660413,8,168,46,222,258
2015-09-20,1.0006000139793695e+20,223625584342,7,121,74,28.66507215007215,8.670431697931697,14,108,33,155,276
2015-09-21,3.25578597236475e+20,727196813510,98,196,286,121.28039177489177,30.574192159692156,47,308,149,504,700
2015-09-22,2.1004862134176684e+20,468950860438,41,112,145,68.8577016039516,26.639055597180597,36,198,91,325,437
2015-09-23,1.7718336329428658e+20,395384588633,20,64,92,54.785537518037515,11.998823953823955,26,182,66,274,338
2015-09-24,2.0252677020673724e+20,451691491693,40,125,156,73.41149506974507,18.27482828282828,32,195,86,313,438
2015-09-25,1.890389893800221e+20,421410219700,29,182,122,62.73786255411255,22.3311075036075,23,186,83,292,474
2015-09-26,8.874949683398964e+19,197729920392,5,35,24,26.82099567099567,5.699314574314574,11,92,34,137,172
2015-09-27,1.600877879790658e+20,356510141556,15,48,53,52.6699025974026,10.04064935064935,10,173,64,247,295
2015-09-28,2.4901440973618764e+20,554282291825,32,219,161,89.11257215007215,23.63945165945166,39,252,93,384,603
2015-09-29,2.7057222813057086e+20,601953630396,34,168,167,90.42903318903319,31.837619949494947,35,258,124,417,585
2015-09-30,3.940575110482466e+20,876273461180,106,466,532,176.86824925074924,57.9624053030303,71,332,204,607,1073
2015-10-01,2.2735545481690946e+20,505298005435,55,212,266,106.22434297184297,28.35549062049062,50,175,125,350,562
2015-10-02,2.5152369581297055e+20,558747057164,45,194,185,93.3878354978355,19.840977633477635,48,242,97,387,581
2015-10-03,6.437589472536483e+19,142943071794,21,71,60,34.476866883116884,11.44439935064935,11,44,44,99,170
2015-10-04,7.092028280137827e+19,157391725231,8,81,35,23.915873015873018,8.321825396825396,8,71,30,109,190
2015-10-05,2.1353520933680552e+20,473648632721,11,134,133,72.08251202501202,16.92186507936508,32,208,88,328,462
2015-10-06,2.1691395060823317e+20,480898362289,43,137,140,87.79617243867244,16.680003607503608,47,192,94,333,470
2015-10-07,2.8676301078778613e+20,635457018211,58,149,186,108.44652688977689,22.50649286824287,51,265,124,440,589
2015-10-08,2.699734562434324e+20,597944367135,49,70,113,94.324139009139,27.31426406926407,49,252,113,414,484
2015-10-09,4.397604668926868e+20,973521838238,119,274,414,173.88373737373738,34.02228445165945,88,394,192,674,948
2015-10-10,8.225218522720053e+19,182003655872,20,58,77,29.736296296296295,9.195768398268397,11,79,36,126,184
2015-10-11,5.290615784266691e+19,117009443881,15,32,38,22.24754329004329,9.037900432900432,7,39,35,81,113
2015-10-12,2.2809963330193598e+20,504186596455,52,145,170,80.32963564213564,11.09583694083694,36,225,88,349,494
2015-10-13,2.4718326704562153e+20,546112703541,77,133,197,112.69758537758538,35.50255411255411,51,186,141,378,511
2015-10-14,2.7284148044137293e+20,602494662311,35,112,93,100.67889466089466,26.978114718614716,42,258,117,417,529
2015-10-15,3.2274022411931366e+20,712342907908,38,92,125,97.96187049062048,27.803623737373737,28,355,110,493,585
2015-10-16,2.633059057445314e+20,580888679520,53,110,119,107.32043290043289,33.361310425685424,38,223,141,402,512
2015-10-17,8.32291371750815e+19,183525414340,30,50,50,40.4383189033189,17.267056277056277,14,54,59,127,177
2015-10-18,1.0032956440750516e+20,221112183237,8,68,45,52.93756854256854,22.69316738816739,8,84,61,153,221
2015-10-19,1.535316101527068e+20,338192172294,37,111,136,72.34369444444445,9.0423373015873,50,109,75,234,345
2015-10-20,7.064105135401139e+20,1555207823087,300,652,931,326.64255862193363,40.87671446608946,240,506,330,1076,1728
2015-10-21,3.1854368487434886e+20,701031695185,109,137,221,143.57065776815776,18.871516955266955,96,254,135,485,622
2015-10-22,1.8072299008840352e+20,397517336403,52,86,95,80.52372474747474,20.49215909090909,39,139,97,275,361
2015-10-23,1.9003324603078338e+20,417780764029,64,79,115,75.10131162818662,15.332325036075035,40,172,77,289,368
2015-10-24,1.0986915710487835e+20,241430289007,12,44,63,43.31000901875902,6.900290404040404,15,111,41,167,211
2015-10-25,6.582186464967936e+19,144576652860,5,26,17,26.680113636363636,8.736940836940837,9,57,34,100,126
2015-10-26,1.2448244834693238e+20,273268738577,26,72,96,60.82144119769119,16.569900793650792,28,84,77,189,261
2015-10-27,2.187960369073702e+20,480058251660,67,103,112,71.52531180856181,20.037395021645022,28,213,91,332,435
2015-10-28,2.657197869404949e+20,582753028618,16,43,38,41.13435696248196,16.081452922077922,11,339,53,403,446
2015-10-29,1.939611246722291e+20,425161418161,20,64,67,55.445107947607944,17.334110056610054,21,207,66,294,358
2015-10-30,2.026436135982511e+20,443986339502,32,87,187,65.45575174825174,16.522761405261406,43,194,70,307,394
2015-10-31,7.0663351000423825e+19,154752797978,18,52,53,25.328892496392495,8.612747113997115,13,61,33,107,159
2015-11-01,7.202803269309075e+19,157655833397,18,114,139,28.978569023569023,9.745324675324675,14,59,36,109,223
2015-11-02,1.9768486566697193e+20,432493402052,45,237,270,73.46091991341991,22.65554834054834,26,189,84,299,536
2015-11-03,4.962120128478261e+20,1084932393661,189,819,993,204.64734126984126,57.54617303992303,98,395,257,750,1569
2015-11-04,5.003784165649612e+20,1093658751567,134,287,435,216.37089081289082,50.59499062049062,122,370,264,756,1043
2015-11-05,1.7946785127727265e+20,392062748090,37,64,144,71.6830315055315,12.498730158730158,42,154,75,271,335
2015-11-06,1.5903019625089892e+20,347236147219,41,97,127,56.59530844155844,14.431060606060605,22,147,71,240,337
2015-11-07,1.3192229081758096e+20,287930884987,12,104,136,35.63411014911015,9.770844155844156,12,148,39,199,303
2015-11-08,7.097860779929533e+19,154827961055,14,52,108,36.362537878787876,5.249380411255411,20,49,38,107,159
2015-11-09,1.3407166491753895e+20,292309840621,22,77,124,58.580912698412696,18.43873015873016,24,112,66,202,279
2015-11-10,1.773091173821451e+20,386392725924,39,59,114,59.94906746031746,19.644285714285715,25,162,80,267,326
2015-11-11,1.7208109185870846e+20,374835587715,29,80,224,66.0912025012025,12.177207792207792,31,160,68,259,339
2015-11-12,1.4027137775365741e+20,305387482120,47,39,108,71.39025432900434,16.922570346320345,25,105,81,211,250
2015-11-13,1.689517259086629e+20,367645313873,57,47,84,67.18411736411736,28.02614718614719,19,150,85,254,301
2015-11-14,6.654515089311161e+19,144749097739,12,13,24,21.03667748917749,5.8183008658008655,6,70,24,100,113
2015-11-15,5.393663630271385e+19,117255129093,8,130,70,21.540238095238095,9.13734126984127,6,43,32,81,211
2015-11-16,2.078737785117625e+20,451677482850,75,84,96,60.41294733044733,23.296098484848486,12,222,78,312,396
2015-11-17,1.3665102631569513e+20,296791313226,15,59,58,52.22828823953824,13.250454545454545,24,118,63,205,264
2015-11-18,1.4406768616014812e+20,312736767449,25,96,121,56.88833694083694,18.590082972582973,23,127,66,216,312
2015-11-19,1.4480679543736404e+20,314201819798,14,88,105,40.80292207792208,18.28349567099567,9,150,58,217,305
2015-11-20,3.39202711572594e+20,735600395391,61,225,276,104.0676491101491,33.613170995671,38,341,129,508,733
2015-11-21,8.884559700790623e+19,192597492562,8,22,44,29.991796536796535,10.476872294372294,8,89,36,133,155
2015-11-22,9.558178572380285e+19,207091874840,7,44,42,36.95485930735931,20.872169913419913,8,85,50,143,187
2015-11-23,9.964627073082222e+19,215793933428,15,71,52,33.24467171717172,11.572824675324675,9,99,41,149,220
2015-11-24,1.492175130050497e+20,322986426663,35,93,124,63.68025432900433,12.964866522366522,27,127,69,223,316
2015-11-25,2.6178909831235214e+20,566349859738,96,105,202,84.23081168831169,39.10057359307359,22,244,125,391,496
2015-11-26,1.098554739936402e+20,237560521774,15,33,66,37.95850649350649,17.18099567099567,9,106,49,164,197
2015-11-27,1.1996995692469989e+20,259304527034,13,45,45,40.99556277056277,11.207698412698413,12,114,53,179,224
2015-11-28,8.315125824831871e+19,179640341635,11,56,61,25.271675824175823,11.726309523809524,3,86,35,124,180
2015-11-29,8.051576831045073e+19,173856651975,2,73,74,22.714891774891775,9.435974025974026,7,82,31,120,193
2015-11-30,1.6111849705078483e+20,347734036928,109,131,144,47.69712481962482,16.759141414141414,8,168,64,240,371
2015-12-01,1.7598396792703133e+20,379632610812,67,143,172,81.33253607503607,26.803272005772005,27,146,89,262,405
2015-12-02,2.5067328129527218e+20,540500612913,86,61,85,60.21605218855219,19.29160173160173,15,270,88,373,434
2015-12-03,1.573417495892388e+20,339100580322,22,36,83,51.54132034632035,14.328487554112554,28,143,63,234,270
2015-12-04,1.500249944995921e+20,323178945253,53,97,136,58.74162097162097,16.968334836459835,25,125,73,223,320
2015-12-05,7.134770770959985e+19,153627126356,7,36,56,29.001320346320345,2.775979437229437,17,60,29,106,142
2015-12-06,6.734662386273083e+19,144940183779,9,20,49,20.313506493506495,5.205135281385282,9,67,24,100,120
2015-12-07,1.57009880549434e+20,337732621614,53,107,116,68.34055916305917,20.460883838383836,30,129,74,233,340
2015-12-08,1.7531320050196648e+19,37689501745,1,3,8,4.212878787878788,-0.10113636363636364,3,17,6,26,29
2015-12-09,1.3626467199973166e+20,292832694267,16,65,79,53.899329004329005,8.36604797979798,33,119,50,202,267
2015-12-10,2.0248199555179335e+20,434925961919,40,76,99,79.31124098124099,21.794503968253967,21,186,93,300,376
2015-12-11,1.8030758407135245e+20,387107616103,35,42,76,54.70425324675325,19.728739177489178,15,183,69,267,309
2015-12-12,9.391285585513769e+19,201538631062,14,22,39,29.762283549783547,9.169949494949496,12,92,35,139,161
2015-12-13,7.503634883631238e+19,160950741803,5,50,54,19.53530303030303,7.32021645021645,7,80,24,111,161
2015-12-14,1.515078946368087e+20,324821331177,14,43,62,48.812063492063494,16.716785714285713,21,145,58,224,267
2015-12-15,8.865467188509347e+19,189974302513,2,26,42,33.59751082251082,14.720887445887445,15,71,45,131,157
2015-12-16,1.774154145462629e+20,379973894267,38,103,163,78.728272005772,23.81044372294372,34,127,101,262,365
2015-12-17,2.4457115457527887e+20,523579732839,54,110,189,74.88065055315055,21.55022186147186,37,229,95,361,471
2015-12-18,1.538688629632927e+20,329250734809,9,66,92,42.622889610389606,14.300524891774892,19,153,55,227,293
2015-12-19,7.052403685476668e+19,150853077968,6,18,28,23.989112554112555,9.33083694083694,6,70,28,104,122
2015-12-20,4.953425062878529e+19,105894838767,6,23,23,15.727045454545454,6.349974747474747,4,50,19,73,96
2015-12-21,1.1541894783495417e+20,246619967152,14,75,66,49.21816378066378,15.123856421356422,15,95,60,170,245
2015-12-22,1.5963000759597924e+20,340934978520,27,68,95,61.22131313131313,19.263084415584416,22,141,72,235,303
2015-12-23,1.0942352982626617e+20,233591033343,10,34,55,35.536049783549785,12.963382034632033,9,101,51,161,195
2015-12-24,8.431823465380959e+19,179918570495,3,19,17,25.16462121212121,7.264707792207791,14,80,30,124,143
2015-12-25,5.44259531722242e+19,116082956355,13,45,50,13.862698412698412,6.6345238095238095,5,60,15,80,125
2015-12-26,7.623855811450674e+19,162526205808,5,34,36,23.486464646464647,9.099772727272727,8,76,28,112,146
2015-12-27,9.194279894592533e+19,195913593000,6,55,66,27.525606060606062,10.65338023088023,4,98,33,135,190
2015-12-28,1.2879223454271504e+20,274296271682,15,63,72,44.277346079846076,16.37570827320827,9,131,49,189,252
2015-12-29,1.8751096627450013e+20,399135716039,50,141,247,70.84331349206349,22.942635281385282,27,158,90,275,416
2015-12-30,2.517286750143527e+20,535596898485,58,136,261,104.64781096681097,33.95345526695527,48,199,122,369,505
2015-12-31,2.006719492521425e+20,426761403406,29,60,110,58.33631313131313,18.007575757575758,17,207,70,294,354
2016-01-01,5.872896210378667e+19,124841883480,19,68,79,17.989372571872572,6.703405483405484,4,59,23,86,154
2016-01-02,7.447703568707725e+19,158239721207,15,36,49,21.275555555555556,8.275833333333333,7,78,24,109,145
2016-01-03,1.3536078377926728e+20,287461850620,47,146,162,54.948593073593074,16.37862554112554,17,122,59,198,344
2016-01-04,3.2627286027921385e+20,692563794431,60,222,295,141.50884355459354,40.068881313131314,61,239,177,477,699
2016-01-05,1.8887797352506468e+20,400750470940,34,96,153,74.9786976911977,21.531204906204906,30,152,94,276,372
2016-01-06,1.3557312597855648e+20,287512476934,26,66,131,64.36623857623857,28.039667207792206,22,100,76,198,264
2016-01-07,1.562009723785286e+20,331095587991,39,49,61,65.16159618159618,17.470868575868575,19,129,80,228,277
2016-01-08,1.0968195991635984e+19,23236381289,4,14,13,6.153441558441559,2.8623593073593074,3,6,7,16,30
2016-01-09,5.486059221251393e+19,116186582378,5,43,60,18.278246753246755,5.308474025974026,6,53,21,80,123
2016-01-10,7.685214225466232e+19,162672495666,18,32,69,27.640425685425686,11.664119769119768,8,67,37,112,144
2016-01-11,2.0047117098542124e+20,424135864200,38,115,152,82.11962842712843,19.679329004329002,34,149,109,292,407
2016-01-12,1.5523797784753462e+20,328288322262,23,88,120,65.71032106782107,7.857410714285715,51,110,65,226,314
2016-01-13,1.835034753957286e+20,387869575958,22,55,91,66.31822871572872,13.505670995670997,29,148,90,267,322
2016-01-14,1.890947892965536e+20,399513328872,42,93,155,68.67029882154883,21.47653409090909,33,164,78,275,368
2016-01-15,1.6511567824430694e+20,348687039194,25,87,115,73.19015091390091,14.16550955988456,47,124,69,240,327
2016-01-16,6.745655665175529e+19,142388723858,10,26,28,29.977983405483407,14.286208513708514,5,52,41,98,124
2016-01-17,6.956006293226399e+19,146756743760,15,45,54,27.088072483072484,13.621118326118326,8,61,32,101,146
2016-01-18,7.786409159915726e+19,164202598168,14,42,56,25.8626443001443,12.363257575757576,9,70,34,113,155
2016-01-19,1.5305949575199883e+20,322613591762,17,83,83,63.84428932178932,16.816298701298702,22,127,73,222,305
2016-01-20,2.0487684887806994e+20,431630434520,35,68,81,57.81577561327561,14.621958874458874,19,213,65,297,365
2016-01-21,1.463124119444458e+20,308116611884,18,91,60,55.41000901875902,17.59373617123617,20,123,69,212,303
2016-01-22,1.0496175057683199e+20,220927747503,23,40,81,40.07393939393939,10.595782828282829,13,94,45,152,192
2016-01-23,4.697816081909391e+19,98841244592,14,24,44,21.088246753246754,10.087402597402598,5,38,25,68,92
2016-01-24,3.3868243999813538e+19,71227732341,7,17,18,15.109848484848484,4.553787878787879,6,26,17,49,66
2016-01-25,9.751910501439508e+19,204976097803,19,157,174,42.76380411255411,14.538712121212122,16,68,57,141,298
2016-01-26,1.8268290396456606e+20,383807431561,45,87,132,72.22755591630592,10.211300505050506,39,155,70,264,351
2016-01-27,1.4539140915240098e+20,305319357754,52,96,231,55.044613997114,13.888685064935064,31,120,59,210,306
2016-01-28,1.745631868377122e+20,366405520457,28,70,148,60.861754148629146,16.050201118326118,26,150,76,252,322
2016-01-29,2.287144411552455e+20,479845313560,24,102,141,44.542339604839604,11.345211038961038,18,261,51,330,432
2016-01-30,2.239545235296391e+20,469688615927,23,226,318,34.09608044733044,12.063306277056277,7,275,41,323,549
2016-01-31,1.040591481875025e+20,218134880376,20,72,92,26.4151443001443,9.713165584415584,6,111,33,150,222
2016-02-01,2.7558848812313395e+20,577372900493,59,163,210,109.41013708513708,35.92787698412698,52,210,135,397,560
2016-02-02,2.6253255950770956e+20,549772260032,53,129,233,96.4694264069264,27.42603896103896,43,219,116,378,507
2016-02-03,3.5926035098146236e+20,751982024047,115,197,297,135.41537157287158,19.341936327561328,87,289,141,517,714
2016-02-04,2.5932116414267274e+20,542562428841,59,103,221,90.3891865079365,21.872965367965367,55,215,103,373,476
2016-02-05,2.956411730878569e+20,618241212431,96,262,406,108.95095598845599,16.1159613997114,68,236,121,425,687
2016-02-06,9.882039079563885e+19,206575183489,29,69,113,39.00131313131313,14.272886002886002,16,81,45,142,211
2016-02-07,9.19158469595332e+19,192040662219,19,100,110,32.56387265512265,7.985306637806638,15,84,33,132,232
2016-02-08,3.086462936906551e+20,644540904332,88,343,467,113.01211038961038,19.799677128427128,65,260,118,443,786
2016-02-09,4.830610710186762e+20,1008333371263,134,343,484,179.61588383838384,30.85407798220298,103,405,185,693,1036
2016-02-10,8.627803673149542e+20,1799991732291,322,898,1279,348.6522255291005,69.55962993025493,185,653,399,1237,2135
2016-02-11,6.872848032041308e+20,1433363915750,171,387,857,272.12291185666186,59.84306878306878,142,535,308,985,1372
2016-02-12,2.415569214496984e+20,503528559043,49,91,427,95.63592907092907,14.45154822029822,51,194,101,346,437
2016-02-13,1.2502427242572127e+20,260509569761,21,52,138,38.16979797979798,12.24599086099086,13,121,45,179,231
2016-02-14,7.547677033882686e+19,157189241547,8,50,67,29.292929292929294,11.057548701298701,6,67,35,108,158
2016-02-15,9.928979554205203e+19,206687098305,20,28,62,34.2779329004329,8.516493506493505,10,91,41,142,170
2016-02-16,2.147794680265329e+20,446879752645,38,131,226,70.7072619047619,20.000422077922078,29,190,88,307,438
2016-02-17,1.455912156881417e+20,302789325401,19,36,75,54.7903373015873,21.837341269841268,14,125,69,208,244
2016-02-18,1.4356083467939095e+20,298438739927,21,41,111,49.72057178932179,9.88262987012987,27,127,51,205,246
2016-02-19,1.1420812719200394e+20,237309440193,17,54,94,38.809208152958156,13.175775613275613,10,103,50,163,217
2016-02-20,9.603923815815987e+19,199467930160,5,62,71,28.766468253968252,6.7546176046176045,9,99,29,137,199
2016-02-21,6.803365024153339e+19,141237478712,5,28,44,20.217056277056276,4.630995670995671,8,70,19,97,125
2016-02-22,1.4175815267569867e+20,294142442106,22,60,82,53.40888888888889,20.581641414141416,14,123,65,202,262
2016-02-23,1.614902969995409e+20,334934331210,24,58,126,47.82630170755171,12.327193362193361,23,147,60,230,288
2016-02-24,1.7491795605290402e+20,362623599108,24,56,77,68.79656746031746,27.28301406926407,16,150,83,249,305
2016-02-25,1.7922655638366054e+20,371383859328,16,50,75,61.39920995670995,13.793326118326117,40,141,74,255,305
2016-02-26,1.3501587080386454e+20,279646607115,12,81,116,40.20068903318903,11.650918710918711,20,121,51,192,273
2016-02-27,5.6987633131918066e+19,117982543425,3,32,58,20.97788059163059,8.408455988455987,5,44,32,81,113
2016-02-28,4.9978508092332016e+19,103423088054,3,57,58,17.0225,6.388863636363636,5,40,26,71,128
2016-02-29,1.8312336529967238e+20,378757105841,22,81,157,73.08536976911977,18.144675324675323,31,145,84,260,341
2016-03-01,3.192355121968498e+20,659953920505,215,531,610,123.0463943001443,14.679009740259739,81,252,120,453,984
2016-03-02,2.5803244954893035e+20,533233330526,63,118,257,91.70394276094277,16.783728896103895,57,208,101,366,484
2016-03-03,2.0174584869604708e+20,416706761190,38,87,159,70.16736471861472,12.929929653679654,45,161,80,286,373
2016-03-04,1.693785047709756e+20,349703376234,50,100,202,63.02440476190476,19.692379148629147,19,130,91,240,340
2016-03-05,5.013038860536365e+19,103459299185,7,21,45,21.385645743145744,3.3433405483405485,13,33,25,71,92
2016-03-06,8.760381411629336e+19,180701913687,20,50,84,28.302440476190476,9.766931818181819,9,82,33,124,174
2016-03-07,1.3430359352739776e+20,276899117026,26,52,119,59.40299062049062,17.071441197691197,27,91,72,190,242
2016-03-08,1.237604182160855e+20,255052903545,15,57,66,47.637730880230876,9.227780182780181,26,89,60,175,232
2016-03-09,1.393896693127287e+20,287133576808,27,92,151,65.44828102453103,12.907276334776334,22,106,69,197,289
2016-03-10,1.9751151572099727e+20,406675372719,46,88,144,79.9265755078255,24.58521964146964,32,158,89,279,367
2016-03-11,3.754125877059098e+20,772587872052,24,68,108,45.033206030081026,12.554552738927738,20,456,54,530,598
2016-03-12,5.385193238107405e+19,110790759237,5,24,25,20.949623015873016,1.3570382395382397,18,38,20,76,100
2016-03-13,2.977629392432884e+19,61230290603,4,20,40,17.059545454545454,5.801601731601732,6,15,21,42,62
2016-03-14,2.9582202097216854e+20,607973650136,40,152,193,89.22011724386724,27.781513347763347,25,278,114,417,569
2016-03-15,1.6536854744611694e+20,339725483088,29,131,211,66.60103354978355,15.301563852813851,35,119,79,233,364
2016-03-16,1.6971856915209378e+20,348495618928,23,117,175,73.96530844155843,22.230844155844153,32,115,92,239,356
2016-03-17,2.0817015482467e+20,427260279952,31,91,176,76.076829004329,17.38739357864358,32,169,92,293,384
2016-03-18,2.3173198486342802e+20,475409412136,72,130,240,95.26324867724867,19.15324963924964,53,166,107,326,456
2016-03-19,6.471372438471201e+19,132712936864,19,43,63,29.675488816738817,7.337380952380952,10,44,37,91,134
2016-03-20,6.048012435486663e+19,123970558116,21,73,116,25.484875679875678,6.32632215007215,8,45,32,85,158
2016-03-21,3.360397822247503e+20,688448235202,101,169,359,116.50206160241875,39.27047155225726,39,280,153,472,641
2016-03-22,2.528694333361155e+20,517825186829,65,107,271,112.55340187590187,41.20320677008177,41,166,148,355,462
2016-03-23,3.363788372774795e+20,688529072219,81,149,377,120.62140692640692,28.659184704184703,60,275,137,472,621
2016-03-24,2.6951808994350734e+20,551437740278,59,224,308,103.35841477966478,30.88719787157287,38,206,134,378,602
2016-03-25,7.204722688197824e+19,147349729852,7,70,117,27.045685425685424,8.91073593073593,4,63,34,101,171
2016-03-26,5.3529194290684174e+19,109424977505,11,70,92,23.50416847041847,5.073318903318903,13,34,28,75,145
2016-03-27,6.855439947983654e+19,140072800029,4,93,54,43.54897907647908,-4.75018759018759,24,40,32,96,189
2016-03-28,2.1219717819598773e+20,433375737037,29,93,221,76.33683658008658,21.549291666666665,24,180,93,297,390
2016-03-29,2.4303818993002175e+20,496148711124,46,115,230,88.21056998556998,21.13247655122655,36,191,113,340,455
2016-03-30,2.4817240435746265e+20,506394648052,52,202,376,98.41921356421356,25.309015151515148,44,183,120,347,549
2016-03-31,8.373245063904485e+19,170757063882,23,67,126,44.75340367965368,10.715853174603174,22,45,50,117,184
2016-04-01,1.2284593914429015e+21,2504528358227,482,1377,2018,543.6435156880157,166.7968112998113,215,832,669,1716,3093
2016-04-02,2.10573735095993e+20,429122173118,103,178,384,82.01876328763828,20.162469877344876,45,140,109,294,472
2016-04-03,1.7987696800957035e+20,366383589644,63,138,287,78.31190416065417,25.964746272246273,34,117,100,251,389
2016-04-04,8.023404141042838e+20,1633499197571,223,501,977,335.21883375883374,83.4818981018981,168,552,399,1119,1620
2016-04-05,6.671537533067881e+20,1357678375890,191,474,827,281.2372952972953,77.77077741702742,120,475,335,930,1404
2016-04-06,5.6557483401117794e+20,1150445507934,195,1430,1030,228.53646945646946,61.919227994227995,94,406,288,788,2218
2016-04-07,5.572316726703326e+20,1132990323561,154,640,711,225.09671966921965,57.25359367484367,111,401,264,776,1416
2016-04-08,3.779006838778585e+20,768025740498,94,756,402,153.57444865319866,40.91103896103896,79,272,175,526,1282
2016-04-09,1.0278489814894582e+20,208809230675,55,182,166,46.52732683982684,18.200429292929293,18,57,68,143,325
2016-04-10,1.0643772177769542e+20,216124306567,31,181,121,44.362160894660896,14.778116883116883,18,73,57,148,329
2016-04-11,4.072693270069471e+20,826581169624,98,567,491,155.27315025252526,40.996537698412695,75,304,187,566,1133
2016-04-12,2.901173009617672e+20,588569849254,73,376,266,108.5548563011063,28.16612012987013,47,216,140,403,779
2016-04-13,3.673405160424352e+20,744886640710,64,357,248,107.663277000777,25.720387667887668,44,336,130,510,867
2016-04-14,2.1978755811851256e+20,445496104430,45,321,203,80.20024100899101,18.440845127095127,38,171,96,305,626
2016-04-15,1.9466597966816313e+20,394397429291,37,300,124,64.58103174603174,19.42080808080808,31,152,87,270,570
2016-04-16,6.924693114047383e+19,140237912450,15,179,199,33.74984307359308,9.303376623376623,10,46,40,96,275
2016-04-17,8.44407126699773e+19,170925926710,18,153,84,32.41403138528138,11.265135281385282,11,62,44,117,270
2016-04-18,1.458578319197429e+20,295119881819,23,200,151,62.40913239538239,12.190110028860028,42,84,76,202,402
2016-04-19,3.2076984857304524e+20,648720220042,79,464,329,123.0519056082806,26.10997965922966,64,241,139,444,908
2016-04-20,2.602045733195079e+20,526018195345,72,516,461,101.29388888888889,38.53806006493507,43,190,127,360,876
2016-04-21,2.234578598349449e+20,451526512442,58,341,241,86.07747655122655,18.783079906204904,48,157,104,309,650
2016-04-22,2.0909779877821763e+20,422326107605,72,238,255,74.41426226551226,16.946920093795093,44,159,86,289,527
2016-04-23,6.225012003479492e+19,125681392943,13,122,99,30.376901154401153,12.360887445887446,7,32,47,86,208
2016-04-24,6.228371579150056e+19,125689402795,19,146,138,30.32759388759389,15.468712121212121,6,34,46,86,232
2016-04-25,2.079594995299116e+20,419477045977,46,279,219,80.36281843156843,26.60839979464979,32,154,101,287,566
2016-04-26,2.3779371913322525e+20,479432312161,78,303,254,84.57386664261664,23.902804834054834,40,193,95,328,631
2016-04-27,2.088929141723853e+20,420988424336,51,319,295,70.8930772005772,18.14455266955267,40,158,90,288,607
2016-04-28,1.683576560251809e+20,339149307142,25,247,202,62.97200937950938,22.836973304473304,21,132,79,232,479
2016-04-29,1.9458392247395074e+20,391800195381,48,253,195,68.13345635845636,23.02398601398601,29,155,84,268,521
2016-04-30,5.955970424057543e+19,119884607938,18,131,106,24.044007335257334,6.1926948051948045,8,42,32,82,213
2016-05-01,8.50332437932154e+19,171067197137,33,199,180,41.67773448773449,14.67241883116883,10,56,51,117,316
2016-05-02,1.9705500258531036e+20,396255851711,55,444,358,80.0305321067821,38.62251443001443,30,135,106,271,715
2016-05-03,2.488112523707899e+20,500102786408,72,474,363,99.02111471861471,24.591484487734487,45,173,124,342,816
2016-05-04,8.771486496150883e+20,1762174678569,270,1334,1456,349.6795504033004,101.11558406870907,171,585,449,1205,2539
2016-05-05,7.486051222105425e+20,1503403722979,180,878,1093,315.16479765604765,70.42651875901876,156,495,377,1028,1906
2016-05-06,2.8632452977678103e+20,574777232394,35,495,293,95.0449975949976,28.79570165945166,36,240,117,393,888
2016-05-07,1.0569331407542791e+20,212080321024,24,182,151,50.31060606060606,8.949917027417028,25,58,62,145,327
2016-05-08,8.167868613649362e+19,163823233403,10,151,99,31.757546296296297,13.879604978354978,8,61,43,112,263
2016-05-09,2.349597178317344e+20,471023623750,68,480,336,99.23295214045214,25.70204365079365,48,158,116,322,802
2016-05-10,2.2850307750743458e+20,457884725968,62,308,435,94.70554653679653,18.165363455988455,58,156,99,313,621
2016-05-11,3.761571704562042e+20,753432869791,67,453,395,125.27752645502645,30.008439754689753,48,345,122,515,968
2016-05-12,2.4626540425645375e+20,493051634064,82,333,283,92.93684343434343,22.574664502164502,41,184,112,337,670
2016-05-13,1.6084665733116618e+20,321892525809,22,221,142,53.44560245310245,18.330746753246753,30,123,67,220,441
2016-05-14,8.996639260863939e+19,179976361314,30,267,282,31.316497113997112,8.432348484848484,14,69,40,123,390
2016-05-15,7.757196982178118e+19,155111106084,20,141,66,29.793474025974024,9.301331168831169,13,52,41,106,247
2016-05-16,1.5815839869029836e+20,316096255104,39,220,196,69.35397727272728,19.629588744588744,29,99,88,216,436
2016-05-17,1.6921851332622785e+20,338065716533,39,215,214,65.79156746031745,18.706818181818182,29,125,77,231,446
2016-05-18,7.043972987891388e+20,1406511813266,350,1152,1792,273.10025384800383,46.72373815536316,202,480,279,961,2113
2016-05-19,5.69764404777722e+20,1137267194721,181,729,980,226.0022851130351,30.501450757575757,155,376,246,777,1506
2016-05-20,3.778282557304322e+20,753831287568,62,296,368,153.25034271284272,37.85692009379509,74,263,178,515,811
2016-05-21,9.688404345079343e+19,193225172568,25,64,153,44.83998556998557,14.437575757575758,15,51,66,132,196
2016-05-22,9.473399860489401e+19,188846057007,13,65,111,38.64270382395382,12.03030303030303,9,66,54,129,194
2016-05-23,2.027922158277222e+20,404067884819,40,167,247,87.79598575036074,24.074338924963925,39,133,104,276,443
2016-05-24,2.1465196608841037e+20,427516829202,37,169,335,83.26276515151515,20.11529220779221,38,160,94,292,461
2016-05-25,2.0961078266813782e+20,417293072603,25,111,217,76.24367965367965,17.419244227994227,45,147,93,285,396
2016-05-26,2.6122627973916407e+20,519817614267,57,388,524,102.2154310966811,21.932619047619045,58,171,126,355,743
2016-05-27,1.8404677792621563e+20,366088914822,13,147,215,61.06618686868687,18.28716810966811,26,156,68,250,397
2016-05-28,6.334039652277736e+19,125941335118,4,69,74,31.716893939393938,10.361390692640693,9,36,41,86,155
2016-05-29,5.45291608424322e+19,108374553137,6,78,76,24.92482683982684,5.3660245310245305,8,36,30,74,152
2016-05-30,5.750550304350198e+19,114239508313,7,99,86,23.90910173160173,6.4990476190476185,6,43,29,78,177
2016-05-31,1.6892905564531166e+20,335419034501,42,135,183,76.68546786546787,15.080600649350648,36,97,96,229,364
2016-06-01,2.3615285049173767e+20,468730418795,65,127,195,99.40428751803752,22.92991883116883,47,142,131,320,447
2016-06-02,1.1593328681784567e+20,229987740455,19,92,125,43.65222883597884,11.04570165945166,18,101,38,157,249
2016-06-03,1.6251755535888515e+20,322290898941,22,156,176,77.28374278499278,20.191320346320346,30,100,90,220,376
2016-06-04,6.79957880083475e+19,134784276785,24,52,77,31.79055735930736,4.647375541125541,7,54,31,92,144
2016-06-05,5.989341333854208e+19,118675335410,12,57,74,22.573713924963926,9.053766233766234,9,39,33,81,138
2016-06-06,1.3908372733382151e+20,275461119784,26,53,116,55.05641053391053,14.077012987012987,25,96,67,188,241
2016-06-07,3.293885905595226e+20,652063923227,85,347,494,130.71671356421356,28.579751082251082,64,228,153,445,792
2016-06-08,2.614092097233866e+20,517283558213,55,129,315,95.24853896103896,31.144211760461758,35,196,122,353,482
2016-06-09,3.5046270841434066e+20,693175763750,100,265,435,121.44987554112554,25.58075036075036,59,262,152,473,738
2016-06-10,4.6032101965142544e+20,910115602387,105,514,590,163.7594271931772,46.097862415362414,86,335,200,621,1135
2016-06-11,1.1716727850702696e+20,231570781982,24,43,80,49.82171356421357,11.734383116883116,25,74,59,158,201
2016-06-12,8.384099389761998e+19,165627602721,28,42,81,27.157222222222224,7.723062770562771,13,63,37,113,155
2016-06-13,1.5218155812076886e+20,300494080557,13,81,147,58.01107142857143,18.60362914862915,31,103,71,205,286
2016-06-14,1.2924238541987683e+20,255071071399,11,62,158,50.62376382876383,7.0278354978354995,32,94,48,174,236
2016-06-15,6.242484361348498e+19,123145380340,8,18,44,30.785757575757575,5.471385281385281,17,28,39,84,102
2016-06-16,1.4645593537945325e+20,288818305922,27,67,129,56.74785894660894,17.412196067821068,27,89,81,197,264
2016-06-17,1.3834979767661843e+20,272708467371,16,55,71,53.1245670995671,11.576717171717172,25,94,67,186,241
2016-06-18,6.250635574053295e+19,123164814346,10,54,43,30.425317460317462,10.851414141414141,6,35,43,84,138
2016-06-19,4.839011095476504e+19,95311374814,10,58,75,17.544929653679652,6.753690476190476,5,36,24,65,123
2016-06-20,1.825009308802214e+20,359276181300,27,219,230,65.53128427128426,15.904957611832613,34,134,77,245,464
2016-06-21,7.528018395917104e+20,1481205268842,427,1221,2198,287.31330552780554,71.50220375457876,140,511,359,1010,2231
2016-06-22,1.626885796763106e+21,3200117713625,546,1295,2408,647.813936082436,93.9550114052614,399,1070,713,2182,3477
2016-06-23,6.295854330215268e+20,1237881582568,165,427,718,233.92094877344877,20.22797619047619,164,448,232,844,1271
2016-06-24,2.6942343086430237e+20,529504977229,35,318,284,97.39012001887002,26.435829448329446,40,211,110,361,679
2016-06-25,7.466663693861546e+19,146685410903,7,45,98,24.392987012987014,8.136991341991342,11,55,34,100,145
2016-06-26,8.142730281155612e+19,159896794019,9,52,70,25.957083333333333,7.822435064935065,16,61,32,109,161
2016-06-27,2.720734108024601e+20,534003286604,72,146,327,110.97034632034632,32.031619769119764,49,180,135,364,510
2016-06-28,2.9612614850115345e+20,580980625331,48,275,281,105.12361346986347,36.23777736152736,40,225,131,396,671
2016-06-29,2.723309943201007e+20,534064699318,63,166,267,112.62481601731602,29.743520021645022,46,166,152,364,530
2016-06-30,3.2337733851184654e+20,633875874406,111,289,444,117.42496572871573,23.25679834054834,60,236,136,432,721
2016-07-01,4.59804839264959e+20,900970690566,166,318,577,181.94642468642468,30.022746975246974,120,292,202,614,932
2016-07-02,1.2286595029337855e+20,240662461052,22,149,105,51.148080808080806,5.258416305916305,32,77,55,164,313
2016-07-03,1.529273501518391e+20,299383056259,61,198,430,58.405315656565655,10.157085137085136,41,93,70,204,402
2016-07-04,1.912316036770427e+20,374246085636,64,170,241,65.72423430735931,12.937399891774891,44,140,71,255,425
2016-07-05,3.946759035492176e+20,772025264550,76,285,437,143.46481541606542,25.85062049062049,87,271,168,526,811
2016-07-06,3.655862726261387e+20,714825192072,100,318,505,125.61188348688349,28.900125985125985,63,275,149,487,805
2016-07-07,2.92901963466381e+20,572478909873,59,225,406,114.67841436341436,19.773427891552892,59,188,143,390,615
2016-07-08,2.2016581232302326e+20,430120267568,50,292,185,84.96897005772006,18.219089105339105,48,150,95,293,585
2016-07-09,8.268982270658295e+19,161486637190,24,58,102,34.39241071428572,9.224896284271285,10,59,41,110,168
2016-07-10,1.0454913213806662e+20,204074516937,22,93,132,42.80667207792207,7.9908116883116875,20,68,51,139,232
2016-07-11,5.2527105642816596e+20,1024841190882,169,493,922,258.1190847115847,27.99796987734487,191,273,234,698,1191
2016-07-12,3.99012560626737e+20,778214544055,88,301,424,175.28740355940354,30.283022727272726,109,246,175,530,831
2016-07-13,3.1635225407336704e+20,616734944058,79,233,354,114.17061674436674,23.921701909201907,53,224,143,420,653
2016-07-14,2.6751937973766275e+20,521318006216,48,171,261,104.04823953823954,15.724403860028858,54,187,114,355,526
2016-07-15,1.839583992262116e+20,358334833844,42,51,195,71.93663810726311,11.520114538239538,35,136,73,244,295
2016-07-16,6.260448427486709e+19,121899375034,8,37,61,23.110642135642134,6.055806277056278,12,43,28,83,120
2016-07-17,8.754409753096033e+19,170376996342,17,46,95,35.461761664261665,14.462849927849927,13,55,48,116,162
2016-07-18,2.3557602145852424e+20,458282212247,60,157,335,94.94515512265512,21.364938672438672,45,162,105,312,469
2016-07-19,2.07733897849062e+20,403957238660,53,77,195,79.3450670995671,17.211537337662335,38,132,105,275,352
2016-07-20,2.4638446522567007e+20,478902835683,93,636,362,93.9913492063492,17.50569264069264,58,160,108,326,962
2016-07-21,7.522765858990963e+20,1461747514003,271,679,1555,326.2358128491878,80.23930573593073,171,417,407,995,1674
2016-07-22,2.48123341539273e+20,481895086061,53,101,214,101.37248015873016,30.444280904280905,46,162,120,328,429
2016-07-23,6.281492195312712e+19,121949547292,3,23,57,24.081666666666667,10.911461038961038,5,45,33,83,106
2016-07-24,1.2191118029546172e+20,236568321218,17,71,122,46.824036796536795,17.785438311688313,22,77,62,161,232
2016-07-25,2.3560803813140447e+20,457001010635,55,189,341,91.11343073593073,23.67024531024531,40,157,114,311,500
2016-07-26,3.5396371967764804e+20,686277460038,112,312,510,139.9416822991823,35.031616161616164,75,223,169,467,779
2016-07-27,3.465276245585477e+20,671616207054,84,381,522,125.61941444203944,39.98912031024531,52,240,165,457,838
2016-07-28,2.0559565846752205e+20,398292102757,51,159,352,75.60024110149111,31.2837012987013,28,134,109,271,430
2016-07-29,2.1480677408608102e+20,415954223552,52,118,213,81.26371933621934,28.06528018278018,24,148,111,283,401
2016-07-30,1.176971791504268e+20,227830615213,26,140,224,50.97689971139971,21.591237012987012,6,79,70,155,295
2016-07-31,9.800457070481662e+19,189625822161,14,221,254,32.77950577200577,15.520386002886003,11,70,48,129,350
2016-08-01,4.940691404985778e+20,955537995649,88,602,868,166.80509776334776,46.503263528138525,83,354,213,650,1252
2016-08-02,2.7148764728960375e+20,524841784888,64,238,402,110.55005411255411,40.91011904761905,41,178,138,357,595
2016-08-03,7.426445356533875e+20,1434963189733,263,930,1367,288.986544011544,78.37032647907648,135,476,365,976,1906
2016-08-04,5.495698006362962e+20,1061566502315,209,422,895,200.5288365800866,50.20314393939394,124,361,237,722,1144
2016-08-05,2.071438261621356e+20,399950049668,66,125,273,81.08473665223666,21.585889249639248,33,141,98,272,397
2016-08-06,1.2114418732453962e+20,233807785904,47,678,219,45.3236525974026,13.892137445887446,20,83,56,159,837
2016-08-07,9.985688228089253e+19,192645117608,33,48,181,34.859756493506495,13.639170274170274,15,70,46,131,179
2016-08-08,1.769337847992661e+20,341194015569,36,224,355,66.1312472943723,22.84319173881674,27,114,91,232,456
2016-08-09,2.1058588466776746e+20,405926040272,61,101,283,84.42999549062048,15.80286075036075,50,131,95,276,377
2016-08-10,2.2901042362560768e+20,441250832044,66,144,273,84.01694083694083,17.29746212121212,51,153,96,300,444
2016-08-11,1.3059363328376083e+20,251526729070,28,172,250,55.395584415584416,11.304246031746032,28,85,58,171,343
2016-08-12,1.4899527431679e+20,286846061543,15,76,141,56.62013888888889,21.23727453102453,15,103,77,195,271
2016-08-13,6.191791411481889e+19,119158014009,11,32,66,23.525221861471863,10.91931277056277,7,41,33,81,113
2016-08-14,5.812398109954554e+19,111809295024,7,36,60,20.02236652236652,9.154752886002886,4,42,30,76,112
2016-08-15,2.5710515033463862e+20,494347195934,79,223,345,96.25749098124098,25.709669011544012,44,176,116,336,559
2016-08-16,1.82965360061122e+20,351653899999,59,110,256,72.37898115773116,22.390704365079365,28,120,91,239,349
2016-08-17,1.8075238678293643e+20,347259781132,64,134,337,80.14930014430014,16.268196248196247,39,116,81,236,370
2016-08-18,1.417601317078449e+20,272232719395,43,49,107,53.42618326118326,11.749635642135642,26,100,59,185,234
2016-08-19,1.5255693127781676e+20,292850566644,44,75,191,62.99270202020202,14.41352813852814,27,105,67,199,274
2016-08-20,7.899606543848984e+19,151584132011,22,88,135,30.59705266955267,10.283088023088023,7,56,40,103,191
2016-08-21,5.9852196486594896e+19,114799003623,26,77,189,23.006774891774892,8.543766233766233,5,42,31,78,155
2016-08-22,1.481669292357495e+20,284070898750,34,49,154,60.305952380952384,19.2125,26,99,68,193,242
2016-08-23,6.129738874181544e+20,1174634672629,204,491,1137,224.15067349317349,57.06731934731934,101,412,285,798,1289
2016-08-24,2.9507728145846655e+20,565264536240,70,175,413,123.74379148629149,32.95084295334295,50,168,166,384,559
2016-08-25,1.637508303869247e+20,313563089802,35,139,267,75.89584415584416,24.537606421356422,21,101,91,213,352
2016-08-26,1.569093619274275e+20,300332441849,41,65,194,63.944990981240984,16.40876984126984,33,96,75,204,269
2016-08-27,7.0025117294311735e+19,133979271613,13,35,81,27.65398629148629,11.216810966810966,8,48,35,91,126
2016-08-28,6.697879268259275e+19,128097631330,24,58,124,23.173510101010102,8.343354978354977,6,43,38,87,145
2016-08-29,1.579055095756386e+20,301858776921,35,119,214,65.19564754689755,19.848166486291486,23,98,84,205,324
2016-08-30,2.0036081382163458e+20,382866833816,39,178,323,80.94635822510823,22.09705808080808,32,132,96,260,438
2016-08-31,3.5773853233029166e+20,683310940573,96,276,537,118.36745088245088,34.83377691752692,62,268,134,464,740
2016-09-01,5.846916625334847e+20,1116338265797,159,549,911,204.94373353498352,41.13119981869982,122,417,219,758,1307
2016-09-02,3.9125246777061723e+20,746721189332,84,527,846,141.6898065129315,29.979141206016205,77,273,157,507,1034
2016-09-03,1.4513920629227137e+20,276904858475,35,105,231,50.49566567691568,14.35398532023532,21,109,58,188,293
2016-09-04,1.042719417577507e+20,198853089703,22,93,157,34.84137806637807,12.090746753246753,12,80,43,135,228
2016-09-05,8.65512924779279e+19,164984953277,14,102,170,31.719574314574317,12.321501623376623,8,62,42,112,214
2016-09-06,2.0952444700590863e+20,399228798939,20,185,427,76.4419727032227,23.6625487012987,33,151,87,271,456
2016-09-07,2.3901641459627586e+20,455235960966,58,157,358,82.00075757575758,20.45238455988456,43,169,97,309,466
2016-09-08,3.056809456017129e+20,581969831499,39,167,279,105.24800986050985,15.27767316017316,62,222,111,395,562
2016-09-09,2.5627253880436385e+20,487704511009,45,167,289,101.57936507936508,18.860579004329004,58,166,107,331,498
2016-09-10,1.1696215002238727e+20,222500030714,44,93,172,40.36353896103896,10.343502886002886,23,79,49,151,244
2016-09-11,9.60954561404365e+19,182726478906,23,85,181,30.823748196248197,8.949080086580086,13,70,41,124,209
2016-09-12,2.985011202706382e+20,567369678006,61,168,465,98.5649512987013,34.56271825396825,29,220,136,385,553
2016-09-13,3.188162541995089e+20,605722892699,62,155,330,107.77812770562771,22.735446127946126,52,245,114,411,566
2016-09-14,3.732751638430226e+20,708925356753,80,233,426,101.77655303030302,15.809516594516595,53,319,109,481,714
2016-09-15,3.734506802827416e+20,708967203126,58,180,318,96.84713924963924,28.108133116883117,46,315,120,481,661
2016-09-16,3.448822830621441e+20,654469072406,92,198,466,111.37974386724386,33.1334613997114,41,262,141,444,642
2016-09-17,1.142344505103746e+20,216694356573,18,103,126,51.1564898989899,21.48064935064935,13,69,65,147,250
2016-09-18,1.0029464713446605e+20,190171818923,36,71,111,42.822435064935064,14.509202741702742,12,67,50,129,200
2016-09-19,1.835755271734605e+20,347932870242,25,99,200,65.73591871091871,22.695842352092352,22,134,80,236,335
2016-09-20,2.217926476459772e+20,420197455536,41,131,198,95.8184274891775,31.689554112554113,36,120,129,285,416
2016-09-21,2.6394458845530826e+20,499844349981,48,185,345,94.55098484848484,28.439314574314572,40,184,115,339,524
2016-09-22,1.9785642984663145e+20,374536732307,37,116,221,81.68324350649351,18.451884559884558,32,127,95,254,370
2016-09-23,1.9872072724828327e+20,376031631842,73,152,328,86.39151455026455,24.605138888888888,28,129,98,255,407
2016-09-24,6.704783872097281e+19,126825258221,11,36,84,30.128535353535355,9.357647907647907,10,38,38,86,122
2016-09-25,7.488089495463956e+19,141581154097,8,38,69,24.64596778221778,9.843904845154846,8,58,30,96,134
2016-09-26,1.5139666143575874e+20,286129761885,28,124,181,61.027034632034635,20.229007936507937,23,101,70,194,318
2016-09-27,1.8504356162711532e+20,349571711915,56,185,413,73.96689574314574,31.83276515151515,24,114,99,237,422
2016-09-28,1.5700340349207157e+20,296488358184,39,120,226,54.86579365079365,11.849457070707071,26,115,60,201,321
2016-09-29,2.1334160340082285e+20,402716549899,61,93,275,86.7623088023088,23.368742784992783,34,140,99,273,366
2016-09-30,1.7435052914942545e+20,328978604661,63,109,221,67.38912337662337,26.71031746031746,25,96,102,223,332
2016-10-01,7.352447691760073e+19,138680088888,16,19,64,25.54753427128427,8.440362554112554,10,52,32,94,113
2016-10-02,8.609226455481876e+19,162297842550,57,225,408,36.084229797979795,11.601804653679654,12,55,43,110,335
2016-10-03,3.7502592149364225e+20,706765099943,102,282,443,128.33489274614274,50.34183954933955,46,258,175,479,761
2016-10-04,1.746717804070513e+20,329055196932,79,113,348,57.66210275835276,14.903482905982905,30,116,77,223,336
2016-10-05,1.4105987022042582e+20,265621589175,47,83,231,52.730974627224626,16.719103535353536,25,90,65,180,263
2016-10-06,3.1125791578927845e+20,585877154746,109,221,460,105.04600288600288,36.46453823953824,42,229,126,397,618
2016-10-07,2.353215483888344e+20,442755521436,60,128,215,82.50261363636363,21.69909632034632,37,172,91,300,428
2016-10-08,9.495073839137895e+19,178587052008,21,37,83,37.08233044733045,6.548879870129871,18,64,39,121,158
2016-10-09,1.774407181325746e+20,333581868048,81,127,401,79.78773448773448,13.117449494949495,32,122,72,226,353
2016-10-10,2.576315886050785e+20,484162028808,71,155,454,97.12512987012987,31.83132756132756,34,170,124,328,483
2016-10-11,1.6344996459212823e+20,307047182929,40,76,187,61.320528499278495,10.537671356421356,32,111,65,208,284
2016-10-12,1.7217526268930464e+20,323304640822,38,127,259,63.65111832611832,14.876217532467532,31,121,67,219,346
2016-10-13,1.510191642053972e+20,283462089584,44,78,169,61.36849927849928,20.588791486291484,26,91,75,192,270
2016-10-14,1.7312107758197975e+20,324818975644,29,113,204,58.12496753246753,17.63822691197691,23,123,74,220,333
2016-10-15,8.502465153542944e+19,159465633819,19,92,141,27.30525974025974,7.997554112554113,10,67,31,108,200
2016-10-16,7.56117917466371e+19,141755413473,19,59,110,23.956565656565655,4.862247474747474,14,53,29,96,155
2016-10-17,3.419898982799475e+20,640891124399,68,281,540,115.61799001924003,31.203685064935065,51,246,137,434,715
2016-10-18,2.790900844999576e+20,522787842239,86,201,395,109.84976677489178,31.16850162337662,50,160,144,354,555
2016-10-19,3.9359519497555784e+20,736969059229,141,1160,487,148.81547743922744,49.46821699134199,59,249,191,499,1659
2016-10-20,6.186177902405148e+20,1157936594290,169,393,751,269.9088140933141,87.78840512265512,110,321,353,784,1177
2016-10-21,1.942015973974583e+20,363354672547,34,76,182,73.3071590909091,35.304990981240984,21,118,107,246,322
2016-10-22,1.0741412637298082e+20,200891079870,25,167,252,42.729074675324675,14.98875,10,76,50,136,303
2016-10-23,1.2326503372556622e+20,230446930158,19,210,314,38.73716824841825,10.003998917748918,21,94,41,156,366
2016-10-24,2.363673132667749e+20,441716016254,52,204,352,75.72138828763829,23.5617316017316,29,175,95,299,503
2016-10-25,2.3885410076816402e+20,446175417508,40,137,255,86.07382395382395,33.29661435786436,32,156,114,302,439
2016-10-26,8.269534073649323e+20,1543993604351,262,1184,2139,318.2844526214526,104.8447886002886,135,504,406,1045,2229
2016-10-27,4.5600009917191415e+20,851087840836,73,198,535,160.121195008695,45.65769862082362,79,306,191,576,774
2016-10-28,2.7007329245482133e+20,503883216829,43,1132,298,86.51583694083693,20.63039953102453,45,185,111,341,1473
2016-10-29,1.9015116575945215e+20,354655964551,57,125,301,79.70401875901877,28.717377344877345,21,122,97,240,365
2016-10-30,8.798891622185868e+19,164038874514,35,110,193,27.70796176046176,15.385692640692639,7,60,44,111,221
2016-10-31,2.1730502754810348e+20,404950338816,43,174,222,81.51357984607985,26.487496392496393,33,137,104,274,448
2016-11-01,3.411921336538347e+20,635545582590,84,279,663,121.50960132460132,32.76911768786769,59,236,135,430,709
2016-11-02,2.9767081980982506e+20,554283369193,69,186,385,91.98983225108225,26.292068001443003,54,209,112,375,561
2016-11-03,1.8742671728667365e+20,348851065524,27,111,193,66.78353535353536,19.16458152958153,29,132,75,236,347
2016-11-04,3.885241485801174e+20,722871677811,65,219,429,164.55139263514263,46.759237012987015,58,265,166,489,708
2016-11-05,1.0333072764833268e+20,192184511901,13,103,140,37.98932900432901,12.078798701298702,12,70,48,130,233
2016-11-06,6.043645663693087e+19,112360632151,12,45,105,18.847104377104376,6.500189995189995,6,46,24,76,121
2016-11-07,2.3948369781425406e+20,445036690162,44,156,264,84.71224687349687,26.218086219336218,30,145,126,301,457
2016-11-08,2.5948683113599533e+20,482026683152,44,220,333,91.63408315295815,28.0121920995671,39,145,142,326,546
2016-11-09,2.205912073002088e+20,409600330046,56,88,207,71.3850529100529,26.938358585858587,36,152,89,277,365
2016-11-10,2.246713399683063e+20,417017284351,38,160,280,86.31760642135642,21.58382756132756,44,125,113,282,442
2016-11-11,1.7375910215120388e+20,322393422604,33,70,140,63.77282467532468,15.104451659451659,26,116,76,218,288
2016-11-12,1.0286803601832722e+20,190785362644,22,98,143,32.350797258297256,8.38657647907648,7,92,30,129,227
2016-11-13,9.8124962555355e+19,181921515973,28,198,230,36.39083527583527,9.984585137085137,11,81,31,123,321
2016-11-14,1.907634907453637e+20,353513119235,16,122,191,65.11812987012986,21.56024675324675,18,135,86,239,361
2016-11-15,2.0921128347514582e+20,387554620164,51,233,353,54.29033910533911,20.12631854256854,22,162,78,262,495
2016-11-16,1.501896965064427e+20,278108989183,28,88,143,62.854733044733045,19.905800865800867,21,99,68,188,276
2016-11-17,3.676689366386637e+20,680523193567,96,374,831,111.87797348484848,37.87338023088023,40,277,143,460,834
2016-11-18,3.078420118155617e+20,569596720100,73,188,368,116.50388250638251,34.642750721500725,59,193,133,385,573
2016-11-19,9.279204980736084e+19,171628205670,26,39,112,34.49974025974026,13.889826839826839,13,54,49,116,155
2016-11-20,9.763909015262537e+19,180516839984,10,72,112,25.13355977355977,5.696410533910534,22,71,29,122,194
2016-11-21,1.841606917643895e+20,340339374513,31,147,192,60.96983266733267,16.327424242424243,43,117,70,230,377
2016-11-22,2.2109514159089058e+20,408431642364,61,118,258,79.24456469456469,23.43573051948052,37,139,100,276,394
2016-11-23,2.5244869588048606e+20,466171476223,51,108,256,91.29481782106782,24.94360209235209,43,171,101,315,423
2016-11-24,1.0342502754324084e+20,190918159773,22,46,90,41.02191558441558,10.010438311688311,20,65,44,129,175
2016-11-25,1.508038184197372e+20,278255407258,22,89,182,46.59072510822511,10.073975468975469,26,115,47,188,277
2016-11-26,9.629848260167685e+19,177619544285,28,63,111,29.52923520923521,6.8498818542568545,21,69,30,120,183
2016-11-27,1.0276265143675912e+20,189471402029,11,43,103,39.51878427128427,7.535707070707071,17,68,43,128,171
2016-11-28,1.7671295844667726e+20,325675346779,19,79,173,64.12494166944167,12.327115023865023,35,114,71,220,299
2016-11-29,2.892971376453141e+20,532954403187,101,215,443,117.3936544011544,15.925133477633478,89,169,102,360,575
2016-11-30,1.816958883579676e+20,334596379686,33,49,144,77.2956240981241,18.147542388167388,40,103,83,226,275
2016-12-01,2.525611836746535e+20,464909460436,80,120,358,101.4708189033189,25.31334686147186,59,146,109,314,434
2016-12-02,2.3094246199619358e+20,424956611216,52,164,380,75.57945586820587,19.970550144300145,39,164,84,287,451
2016-12-03,9.016596198472594e+19,165846757648,22,129,131,32.59053932178932,6.115598845598846,21,57,34,112,241
2016-12-04,7.087043104471309e+19,130314305194,25,53,86,30.35978021978022,9.962678571428572,11,41,36,88,141
2016-12-05,1.925786496135179e+20,353945886825,45,162,295,80.81763528138528,26.442594696969696,30,113,96,239,401
2016-12-06,1.6928659729205235e+20,311016414561,28,62,180,67.41066114441114,16.148917471417473,30,104,76,210,272
2016-12-07,2.3065979134310023e+20,423600382321,60,167,345,94.82668650793651,26.07698593073593,43,113,130,286,453
2016-12-08,1.7750150979705943e+20,325863352069,25,64,205,62.69718253968254,14.618383838383838,37,111,72,220,284
2016-12-09,1.9776513582821153e+20,362915451349,35,199,249,71.57834054834055,8.147900432900432,38,138,69,245,444
2016-12-10,7.02566628543197e+19,128879136489,17,380,147,24.91013924963925,8.904534271284271,11,44,32,87,467
2016-12-11,5.33220274906961e+19,97776070325,17,39,115,18.274208152958153,5.822256493506494,13,30,23,66,105
2016-12-12,1.7621108539263156e+20,322978020973,23,378,259,51.27178150553151,12.261589105339105,20,138,60,218,596
2016-12-13,3.073038944299949e+20,563024248039,50,270,525,97.07477453102453,21.905266955266953,48,225,107,380,650
2016-12-14,2.7021973685589947e+20,494896287078,54,172,391,87.26446095571096,33.88070707070707,32,181,121,334,506
2016-12-15,2.2905631099638697e+20,419351577887,43,187,327,67.25541486291486,20.225093795093795,31,172,80,283,470
2016-12-16,1.9353053702552627e+20,354172834474,38,172,296,69.85111652236652,22.260503246753245,27,122,90,239,411
2016-12-17,1.1341349075364184e+20,207476779693,25,110,182,39.555133477633476,10.840308441558442,15,74,51,140,250
2016-12-18,7.537147247533787e+19,137831611962,28,85,74,30.231895743145742,11.67767316017316,8,46,39,93,178
2016-12-19,1.8487934783227986e+20,337933045527,22,150,253,64.78368575868576,17.64737554112554,35,105,88,228,378
2016-12-20,2.8798435433077323e+20,526197236375,123,206,388,104.74960978835979,40.57367514430015,40,176,139,355,561
2016-12-21,2.3454372972903186e+20,428392890308,31,223,403,78.43021404521404,19.48564393939394,44,155,90,289,512
2016-12-22,1.6968979746741115e+20,309823709993,46,101,214,54.73344877344877,16.751235569985568,25,115,69,209,310
2016-12-23,1.6895587932727673e+20,308359895311,40,199,301,61.68849927849928,24.7040873015873,22,102,84,208,407
2016-12-24,6.9884489530684916e+19,127501568477,24,40,92,27.30030663780664,5.547943722943723,14,46,26,86,126
2016-12-25,4.552755773334546e+19,83029374171,4,148,61,21.445526695526695,11.053598484848484,1,22,33,56,204
2016-12-26,6.913591030445636e+19,126034258301,26,88,164,25.66978354978355,6.646233766233767,11,46,28,85,173
2016-12-27,3.076035095535611e+20,560518011898,60,848,756,102.6128878066378,29.65824044011544,47,206,125,378,1226
2016-12-28,1.986390336679855e+20,361834969858,47,793,376,70.70143398268398,23.82152417027417,24,129,91,244,1037
2016-12-29,2.3456801516278356e+20,427109845431,58,468,396,76.2954268879269,17.599339826839827,41,155,92,288,756
2016-12-30,2.0207778822227667e+20,367810172729,49,516,401,78.26641428016428,36.250665584415586,32,111,105,248,764
2016-12-31,8.722211175456894e+19,158700714183,19,51,126,32.76189063251563,11.09321699134199,12,58,37,107,158
2017-01-01,8.726204258116857e+19,158710234435,30,83,185,30.258198051948053,11.608685064935065,11,59,37,107,190
2017-01-02,1.1422667532112301e+20,207670658008,18,63,133,38.19037443112443,12.053426767676768,19,76,45,140,203
2017-01-03,3.510173781347234e+20,637888103418,105,511,774,141.03080808080807,33.46683802308802,69,198,163,430,941
2017-01-04,6.606675964479447e+20,1200182923695,138,652,1262,243.08540223665224,61.526488997113994,118,401,290,809,1461
2017-01-05,3.235250457727707e+20,587513031479,48,263,519,117.88400432900433,31.607633477633478,57,207,132,396,659
2017-01-06,2.591080883483754e+20,470336869064,50,190,341,84.84175685425686,28.304292929292927,41,171,105,317,507
2017-01-07,1.0630191831215435e+20,192892898958,20,74,150,43.48260101010101,14.030927128427129,18,62,50,130,204
2017-01-08,1.1043748553510588e+20,200323069892,33,73,154,40.70497835497835,10.788993506493506,22,62,51,135,208
2017-01-09,2.0216057328620493e+20,366541075251,45,176,326,68.17982082732082,19.633692279942277,24,138,85,247,423
2017-01-10,2.35003783818017e+20,425924905808,49,133,286,83.47531204906205,31.29293740981241,23,161,103,287,420
2017-01-11,2.1134372916649237e+20,382907694946,51,145,297,70.43967051467051,19.07810155122655,49,123,86,258,403
2017-01-12,2.0406462153763507e+20,369572705680,52,130,329,76.9225036075036,23.837242063492063,33,118,98,249,379
2017-01-13,3.533913826902073e+20,639742945198,115,267,595,138.4121262996263,51.856533189033186,59,189,183,431,698
2017-01-14,1.7881309696512603e+20,323598388861,73,136,293,64.26786075036075,16.913709415584414,26,113,79,218,354
2017-01-15,2.215803080616905e+19,40081430523,4,10,19,7.6469696969696965,2.781060606060606,3,13,11,27,37
2017-01-16,9.933777264172913e+19,179633002472,24,65,145,32.700693001443,13.533260822510822,9,63,49,121,186
2017-01-17,1.9137624242403217e+20,345926200781,34,114,225,66.33135822510822,10.951737012987012,31,131,71,233,347
2017-01-18,1.9967856474636642e+20,360793978397,51,147,322,77.65494468494468,26.691862373737372,25,120,98,243,390
2017-01-19,5.705313757163539e+20,1030476751999,175,491,977,191.37599687349686,41.864354256854256,101,378,215,694,1185
2017-01-20,2.360361930706367e+20,426171051344,59,180,397,93.44733706108705,36.83939033189033,28,137,122,287,467
2017-01-21,8.88606588975306e+19,160380209240,15,87,120,33.26460678210678,13.368362193362193,7,58,43,108,195
2017-01-22,8.231402420325081e+19,148508690099,32,94,167,36.30510101010101,3.227772366522367,21,45,34,100,194
2017-01-23,3.1788266021950403e+20,573279432202,95,228,537,124.62002682502683,51.91467712842713,48,163,175,386,614
2017-01-24,3.295645938991483e+20,594108311855,120,2102,666,119.84157798220298,34.05375450937951,49,201,150,400,2502
2017-01-25,2.761181452620026e+20,497591412194,77,183,381,109.01813852813852,30.388006854256854,52,163,120,335,518
2017-01-26,2.30892457643116e+20,415922844445,75,95,295,78.73122658822659,18.161004329004328,33,153,94,280,375
2017-01-27,2.5492626588155026e+20,459029165108,88,158,397,77.87835618085617,26.91608225108225,32,180,97,309,467
2017-01-28,1.0233512008459778e+20,184214130719,37,59,139,36.30766089466089,11.090358585858585,16,65,43,124,183
2017-01-29,7.017818743333346e+19,126282756535,30,91,184,26.90995670995671,8.582900432900432,10,46,29,85,176
2017-01-30,2.0568821614627052e+20,369959800789,38,127,332,72.28641927516928,25.05973595848596,29,131,89,249,376
2017-01-31,2.578490797261364e+20,463592523150,67,1063,485,96.36714826839827,26.679580176767676,43,153,116,312,1375
2017-02-01,2.72015624818109e+20,488880285265,95,301,573,84.86724206349206,24.93484668109668,36,182,111,329,630
2017-02-02,1.9934461202532185e+20,358136687925,69,94,292,71.64501743626744,16.05381313131313,34,125,82,241,335
2017-02-03,2.2921742086673705e+20,411656979634,69,97,295,83.07472222222222,28.50445346320346,34,145,98,277,374
2017-02-04,8.526700550339456e+19,153079240634,29,77,172,32.551818181818184,12.465646645021645,11,53,39,103,180
2017-02-05,6.0459276432453575e+19,108499567895,21,39,162,22.917506613756615,6.610833333333334,14,31,28,73,112
2017-02-06,2.394791361433067e+20,429569582896,138,204,624,93.80554545454545,26.22353823953824,48,130,111,289,493
2017-02-07,3.465024962534663e+20,621345652012,102,229,530,131.21564874939875,36.77011363636363,58,185,175,418,647
2017-02-08,3.533033547752923e+20,633277782835,150,272,863,125.63617604617605,35.13537337662338,60,204,162,426,698
2017-02-09,6.41343285428359e+20,1149177589857,232,361,1042,253.58757828282828,55.41824392736893,115,356,302,773,1134
2017-02-10,3.4114762939214745e+20,611047107453,177,252,685,143.4824642857143,23.95879383116883,76,192,143,411,663
2017-02-11,8.470020678827536e+19,151655270316,58,66,185,37.114871933621934,12.189908008658008,14,45,43,102,168
2017-02-12,1.0218590010053342e+20,182889718924,80,124,319,43.624025974025976,12.630050505050505,22,41,60,123,247
2017-02-13,4.953795448915716e+20,886253331804,234,442,1164,184.36496873496873,58.676797138047135,79,285,232,596,1038
2017-02-14,4.415304978891701e+20,789640445210,159,261,684,171.8352602906353,51.56968027805528,60,244,227,531,792
2017-02-15,3.002978915456742e+20,536866022277,132,324,860,114.4017137029637,24.72093795093795,55,181,125,361,685
2017-02-16,3.778454805257687e+20,675216460858,146,245,711,132.56752886002886,26.5901443001443,73,237,144,454,699
2017-02-17,3.89657558956973e+20,696076369451,142,329,714,139.4020615165258,44.93953566274995,65,222,181,468,797
2017-02-18,8.079309589307821e+19,144279567615,31,134,264,35.29368903318903,10.126242424242424,16,36,45,97,231
2017-02-19,9.916359479375076e+19,177013805291,33,142,284,38.27266354016354,10.73813492063492,14,58,47,119,261
2017-02-20,1.342158026777262e+20,239501971814,42,175,335,52.814502164502166,21.690061327561327,14,73,74,161,336
2017-02-21,3.219434009318643e+20,574247588220,118,326,767,109.64564466089466,28.597935786435784,44,197,145,386,712
2017-02-22,9.829901670465093e+20,1752610718457,424,2831,2341,342.8385443722944,97.91658098845599,143,597,438,1178,4009
2017-02-23,1.0275688043647786e+21,1831547347469,320,2057,1688,362.43000072150073,75.82328841991341,186,633,412,1231,3288
2017-02-24,4.1755792973952654e+20,743971055384,156,377,972,146.30710654160654,46.16980303030303,70,252,178,500,877
2017-02-25,1.3450778916181628e+20,239571586806,49,372,284,46.80709776334776,4.765611471861472,28,80,53,161,533
2017-02-26,8.525264151635896e+19,151786981018,51,60,195,30.01179292929293,11.325454545454546,10,54,38,102,162
2017-02-27,5.652946024410315e+20,1006029178422,169,291,924,179.99933237133237,36.39662121212121,102,370,204,676,967
2017-02-28,3.764618394024177e+20,669731235204,151,1046,628,130.77221340960628,37.40319552669553,54,228,168,450,1496
2017-03-01,2.6781831537905068e+20,476280053940,104,154,571,88.50709054834054,15.665001803751803,50,153,117,320,474
2017-03-02,2.763045337395845e+20,491191675799,90,142,507,89.26460137085137,21.3013474025974,43,179,108,330,472
2017-03-03,2.8480768050702765e+20,506107333703,120,159,592,98.91450913900914,21.01812463924964,45,176,119,340,499
2017-03-04,1.1564227879667048e+20,205430494231,28,70,255,38.61023912595341,6.626416975881261,17,78,43,138,208
2017-03-05,8.886595839982802e+19,157803802795,29,57,193,33.495340909090906,9.648652597402597,17,47,42,106,163
2017-03-06,1.660706389391418e+20,294783650657,27,82,261,57.86760101010101,16.052128427128427,28,98,72,198,280
2017-03-07,1.5775166054972876e+20,279911901904,39,50,255,52.00520382395382,17.303783369408368,17,96,75,188,238
2017-03-08,3.047285853747718e+20,540500051954,72,152,498,106.06635956635957,19.8373088023088,49,182,132,363,515
2017-03-09,2.166753995663883e+20,384178864233,78,98,366,68.24833273208273,19.955081168831168,26,152,80,258,356
2017-03-10,5.461733508029426e+19,96796060740,13,46,120,14.450000000000001,6.595454545454545,6,38,21,65,111
2017-03-11,9.750133453075402e+19,172750986640,31,63,181,30.264238816738818,9.695061327561328,16,61,39,116,179
2017-03-12,8.24070197610806e+19,145953192029,36,72,189,33.417085923335925,9.419808663558664,13,44,41,98,170
2017-03-13,2.3472059417389495e+20,415546708344,78,172,476,81.89537157287157,14.436302308802308,32,157,90,279,451
2017-03-14,4.957432707579707e+20,877318205974,209,211,889,182.34666396103896,53.67899891774891,82,290,217,589,800
2017-03-15,4.5638738660077194e+20,807359788228,168,324,1047,177.9762584175084,24.355525793650795,117,237,188,542,866
2017-03-16,4.96992665607581e+20,878904919916,211,327,1031,181.59758417508417,43.36762987012987,82,301,207,590,917
2017-03-17,3.429901137262698e+20,606331050037,118,183,593,128.32280062530063,24.06041847041847,80,189,138,407,590
2017-03-18,9.779631879166437e+19,172821316371,112,64,187,36.84072510822511,8.309788961038961,18,59,39,116,180
2017-03-19,1.1217904705755398e+20,198160620572,21,91,197,35.615367965367966,16.965746753246755,11,73,49,133,224
2017-03-20,2.2361447905912465e+20,394855114519,67,109,336,71.14673738298738,15.507191558441558,45,133,87,265,374
2017-03-21,2.4059099949980343e+20,424679331884,79,936,397,88.64417207792208,10.257358405483405,49,144,92,285,1221
2017-03-22,1.8495300406817676e+20,326351091773,49,353,376,62.01292929292929,15.520680014430013,22,121,76,219,572
2017-03-23,1.7827374139839473e+20,314447951663,56,568,324,58.34486231361231,16.1091341991342,20,118,73,211,779
2017-03-24,2.7810218557147038e+20,490331434429,91,124,530,104.33185365560365,29.827276334776336,42,168,119,329,453
2017-03-25,1.1500449656799789e+20,202700765147,39,101,273,39.67738095238095,14.948214285714284,9,77,50,136,237
2017-03-26,8.71375644201229e+19,153525216635,22,55,160,34.428226911976914,18.03710497835498,9,49,45,103,158
2017-03-27,3.351719378972078e+20,590289866954,114,327,897,122.42681707181707,33.510613206238204,61,188,147,396,723
2017-03-28,7.163310312474408e+20,1261141014790,201,617,1408,241.30905436230435,74.03528976578977,101,442,303,846,1463
2017-03-29,3.320513674351301e+20,584390525086,74,1804,575,126.53616281866282,28.378634559884556,62,188,142,392,2196
2017-03-30,2.7372582535524765e+20,481555018998,62,139,409,87.73080086580086,32.90270382395382,31,165,127,323,462
2017-03-31,2.789278238778208e+20,490528281944,104,235,526,96.36318253968254,27.73800072150072,38,163,128,329,564
2017-04-01,9.075393434773599e+19,159542766310,81,134,491,39.173264275407135,12.903199082663368,16,38,53,107,241
2017-04-02,1.8584279497720185e+20,326563234454,67,216,608,62.1623581048581,23.537782287157288,16,114,89,219,435
2017-04-03,1.435545869164825e+21,2521680747670,584,2618,4444,531.8396642015392,146.22124278499277,208,795,688,1691,4309
2017-04-04,1.0862028581603011e+21,1907390874005,398,1130,2432,390.06593554593553,110.55583122895622,162,619,498,1279,2409
2017-04-05,5.785969002667179e+20,1015644868229,180,296,1027,204.23572871572873,58.14999458874459,84,335,262,681,977
2017-04-06,4.768475181865512e+20,836725728226,148,1261,742,167.95306175306175,45.70639145576645,72,275,214,561,1822
2017-04-07,3.34189318005945e+20,586189087203,134,271,716,126.4481636002886,29.935223845598845,61,187,145,393,664
2017-04-08,1.0633589758032293e+20,186456825377,26,83,208,38.433035714285715,10.003075396825396,17,63,45,125,208
2017-04-09,1.0382734685457482e+20,181992235353,35,161,286,40.37252645502645,13.300483405483405,13,60,49,122,283
2017-04-10,9.502219907045493e+20,1664890408024,321,1279,2016,346.516299001924,85.74499639249639,133,534,449,1116,2395
2017-04-11,6.141375897456188e+20,1075671827888,183,470,921,235.06329094516593,42.276090969215964,120,330,271,721,1191
2017-04-12,5.377255612323547e+20,941458632954,199,329,845,186.3184182021682,47.41178841991342,94,313,224,631,960
2017-04-13,6.922776262260604e+20,1211585847011,270,491,1240,227.24684824434823,60.265295815295815,104,406,302,812,1303
2017-04-14,2.6524352228740943e+20,464066660660,95,161,526,97.59126984126983,29.14810696248196,39,156,116,311,472
2017-04-15,1.228631795724312e+20,214885100974,70,75,179,45.0248013494442,9.521970727685012,20,66,58,144,219
2017-04-16,1.3742891716102023e+20,240268037993,47,150,384,46.077011183261185,17.642555916305916,17,86,58,161,311
2017-04-17,3.860013692960565e+20,674583306321,184,337,686,131.7056207912458,42.69421807359307,47,226,179,452,789
2017-04-18,3.4344530209482473e+20,599995400525,78,177,461,112.52380266955267,21.591233405483404,52,216,134,402,579
2017-04-19,3.8119679023729725e+20,665704795565,145,1253,1144,145.34511964886966,42.18213383838384,60,212,174,446,1699
2017-04-20,4.882476564094377e+20,852332082727,166,872,1122,170.4580248917749,28.011861471861472,100,290,181,571,1443
2017-04-21,3.9520296524143034e+20,689665487498,163,187,627,129.80952047952047,37.481908369408366,58,243,161,462,649
2017-04-22,1.3179038454443455e+20,229901862238,57,65,224,48.18796717171717,17.59478896103896,14,75,65,154,219
2017-04-23,8.732437788122651e+19,152280921458,34,36,174,28.424325396825395,8.398492063492064,14,55,33,102,138
2017-04-24,3.42594253610474e+20,597214824813,159,190,608,115.27166065416066,29.815549242424243,56,202,142,400,590
2017-04-25,4.618657679098921e+20,804799431178,193,292,844,163.62489117364117,28.00948142135642,87,264,188,539,831
2017-04-26,3.9860349250314817e+20,694342741291,141,228,552,156.813170995671,35.12093614718614,66,189,210,465,693
2017-04-27,3.215929922749013e+20,559986859579,131,160,466,105.081397005772,34.76011634199134,40,198,137,375,535
2017-04-28,3.4576280567322634e+20,601836771420,166,237,695,133.7392836792837,35.12013861138861,64,175,164,403,640
2017-04-29,1.750852483510341e+20,304665910862,65,202,388,69.80674693362194,9.734947691197691,40,90,74,204,406
2017-04-30,1.3052152885335536e+20,227021673518,54,260,335,46.55641414141414,13.697108285233286,20,69,63,152,412
2017-05-01,5.6354367547163076e+20,979835025435,158,316,1070,200.2243614163614,68.35378647741148,68,313,275,656,972
2017-05-02,4.451741163864124e+20,773754296894,131,229,667,155.46557247382248,39.41534225959226,67,249,202,518,747
2017-05-03,2.9407837271656848e+20,510895308925,146,316,958,101.37216702741702,36.09788618326118,40,162,140,342,658
2017-05-04,9.659216275640042e+20,1677655337939,352,1410,2092,347.2264201539202,90.5808167989418,180,520,423,1123,2533
2017-05-05,5.61894701778403e+20,975575374515,160,1611,1827,212.64912157287156,66.49660894660894,76,305,272,653,2264
2017-05-06,1.8765760458808066e+20,325707083809,27,290,246,64.23624098124098,22.41731240981241,19,107,92,218,508
2017-05-07,1.3865041600767245e+20,240559266018,56,125,277,48.719669913419914,18.074395743145743,16,83,62,161,286
2017-05-08,4.600952955130781e+20,797933142817,158,524,1019,156.17702561327562,51.41589285714286,64,258,212,534,1058
2017-05-09,4.887272606444457e+20,847291089389,167,243,741,180.6238207070707,67.27867388167388,63,270,234,567,810
2017-05-10,4.699659921056886e+20,814463684987,150,1347,1537,168.94595857845857,56.336924001924004,64,262,219,545,1892
2017-05-11,4.0199595349132653e+20,696440401988,135,305,699,143.6096127021127,37.04050054112554,70,228,168,466,771
2017-05-12,3.503934521797311e+20,606807308495,122,212,616,123.14238936988937,29.455200216450216,70,188,148,406,618
2017-05-13,1.4159253044959761e+20,245127225677,52,80,283,54.81822330447331,23.74023088023088,13,77,74,164,244
2017-05-14,1.071019158483957e+20,185350623390,31,69,208,45.56792207792208,19.820082972582973,9,50,65,124,193
2017-05-15,4.5539158024358035e+20,787789844875,112,315,721,155.08825998075997,36.5125955988456,79,272,176,527,842
2017-05-16,3.146639397385693e+20,544157660000,85,387,422,108.81321817071817,30.065106421356422,54,170,140,364,751
2017-05-17,2.5685696470476584e+20,444023459882,63,165,380,85.15630411255411,20.54656385281385,40,152,105,297,462
2017-05-18,3.244560679126107e+20,560669470002,107,1239,744,110.98244805194805,30.557331890331888,48,178,149,375,1614
2017-05-19,2.7438412840872257e+20,473978960832,87,185,393,88.27720268157768,32.57197961760462,31,172,114,317,502
2017-05-20,1.2728322462462044e+20,219805426762,32,71,173,49.439152236652234,20.825016233766235,10,75,62,147,218
2017-05-21,7.88293080645002e+19,136078354271,24,156,199,31.04686507936508,12.484073773448774,6,48,37,91,247
2017-05-22,2.755999148049019e+20,475557661867,46,105,287,92.93221801346802,25.13630411255411,47,158,113,318,423
2017-05-23,3.6674534064282305e+20,632616097070,135,246,582,129.115,38.29207972582972,51,225,147,423,669
2017-05-24,3.5041991202854476e+20,604235947074,145,175,505,128.88493801568802,37.59224517149517,60,185,159,404,579
2017-05-25,3.7573540790544964e+20,647647845885,140,163,528,144.75839094173023,40.572831658420945,57,199,177,433,596
2017-05-26,4.531491319186378e+20,780811028666,140,361,679,151.52991716616717,54.75878427128427,60,270,192,522,883
2017-05-27,1.3634058469277788e+20,234853219417,34,311,255,54.181690476190475,21.74811111111111,13,67,77,157,468
2017-05-28,1.2424429034190715e+20,213925548473,55,59,182,38.01654461279461,8.984751082251082,23,73,47,143,202
2017-05-29,1.5818840479177717e+20,272283019998,50,91,322,61.38465007215007,24.209929653679655,22,85,75,182,273
2017-05-30,4.582672247003141e+20,788475451939,157,330,1128,169.4302558922559,57.89821121933622,49,260,218,527,857
2017-05-31,5.828459467429265e+20,1002480735140,180,482,1445,209.67254617604618,54.82031818181818,92,313,265,670,1152
2017-06-01,4.7082360213527967e+20,809512815259,164,600,761,161.32532647907647,43.24310425685425,70,279,192,541,1141
2017-06-02,3.778504029374189e+20,649440934967,105,343,488,131.6717658730159,40.47991973304473,55,231,148,434,777
2017-06-03,1.4109677904269622e+20,242431359384,31,100,196,55.31352368927369,12.86304797979798,20,81,61,162,262
2017-06-04,1.141458847537592e+20,196051881265,47,128,253,36.13096861471861,9.088759018759017,13,70,48,131,259
2017-06-05,4.454699563357813e+20,764802985818,220,996,904,138.15442760942761,35.48164072039072,79,276,156,511,1507
2017-06-06,8.32866133836335e+20,1429408160520,294,742,1659,282.024174001924,67.75000468975469,136,493,326,955,1697
2017-06-07,6.29022990790038e+20,1079220784062,254,566,1328,212.73727725977724,54.052528166278165,90,362,269,721,1287
2017-06-08,6.877927956085067e+20,1179584540694,284,376,1297,252.86241489991488,58.28645021645021,135,360,293,788,1164
2017-06-09,8.269095871099054e+20,1417677329320,294,746,1351,304.310944000444,65.80041526529027,155,429,363,947,1693
2017-06-10,1.537353648386987e+20,263488322695,69,113,313,59.276025863025865,18.35347186147186,19,74,83,176,289
2017-06-11,1.35453795577511e+20,232064122474,48,175,309,52.70343193843194,16.65779942279942,19,74,62,155,330
2017-06-12,4.5811487302569506e+20,784572623558,127,297,917,167.77666841491842,35.36705036630037,80,268,176,524,821
2017-06-13,6.454885076329241e+20,1105056663732,239,586,1141,235.7428412097162,75.4984586940837,92,339,307,738,1324
2017-06-14,6.404830599138611e+20,1096130262163,243,548,1246,227.74467965367964,58.2784218975469,103,342,287,732,1280
2017-06-15,4.788160997470097e+20,819151385030,151,279,613,155.75459702334703,37.84389166389166,79,287,181,547,826
2017-06-16,3.1876210901183824e+20,545134739696,98,276,706,111.95694324194324,40.61694985569986,35,174,155,364,640
2017-06-17,1.2089344506788569e+20,206682469828,48,218,245,47.32236652236652,16.128214285714286,16,61,61,138,356
2017-06-18,8.238211508957197e+19,140791914393,11,95,141,29.75015873015873,12.352664141414142,8,50,36,94,189
2017-06-19,3.893091049723309e+20,665061252167,160,528,790,127.25246212121212,28.28751172438672,66,227,151,444,972
2017-06-20,4.841901526244922e+20,826876833936,157,349,1156,166.59935434935434,37.89262048137048,66,284,202,552,901
2017-06-21,3.843535243235968e+20,656146739826,162,218,859,131.14871873496872,42.18904581529581,49,215,174,438,656
2017-06-22,5.934668934523541e+20,1012745976017,312,626,1633,204.86627741702742,46.30520256132756,90,353,233,676,1302
2017-06-23,4.039884790827763e+20,689182447273,123,455,630,136.14376058201057,46.65105393217893,50,236,174,460,915
2017-06-24,1.5111694415690324e+20,257708702658,70,130,349,63.26426767676768,30.144141414141416,14,69,89,172,302
2017-06-25,1.5381459246197817e+20,262218377059,72,136,270,69.30833874458875,33.84929112554113,8,73,94,175,311
2017-06-26,3.6580242023029886e+20,623369442511,80,169,477,154.047686988937,44.96547077922078,56,173,187,416,585
2017-06-27,4.5656583730396404e+20,777759129795,180,508,876,167.63238275613276,56.98921717171717,70,240,209,519,1027
2017-06-28,1.3289920576098371e+20,226299720903,60,143,294,50.88146284271284,19.762079725829725,17,68,66,151,294
2017-06-29,4.14682575025065e+20,705909303143,108,422,543,166.93391414141414,44.950248917748915,79,211,181,471,893
2017-06-30,3.90184838373643e+20,663981208302,111,158,451,151.35840141340142,53.1047601010101,38,217,188,443,601
2017-07-01,1.8326912205861467e+20,311772438307,32,129,264,90.03508417508418,44.251381673881674,13,75,120,208,337
2017-07-02,2.247806284247043e+20,382244796441,71,111,308,112.96056096681097,44.74207251082251,23,92,140,255,366
2017-07-03,8.439524685634904e+20,1434629018662,312,634,1696,314.9055584415584,90.58540746753246,118,447,392,957,1591
2017-07-04,2.4436515940020322e+20,415268481926,47,108,268,99.66839586339586,42.52499278499278,28,124,125,277,385
2017-07-05,1.022968005554806e+21,1737654313421,531,713,2178,363.63379407629407,72.23632862507863,190,574,395,1159,1872
2017-07-06,1.526646784160545e+21,2592376627380,603,2080,2860,539.7053885466386,104.40085076960077,287,841,601,1729,3809
2017-07-07,9.945949185632553e+20,1688358088164,418,603,1897,355.72835467772967,76.63801136363637,189,547,390,1126,1729
2017-07-08,2.8365355282354907e+20,481344303737,64,161,408,99.56389790764791,27.739113155363157,37,171,113,321,482
2017-07-09,3.0675607322663997e+20,520362083132,145,312,667,121.0260303030303,42.9955064935065,37,152,158,347,659
2017-07-10,7.74746142571342e+20,1313733311837,231,397,1164,277.591942039442,85.90535894660894,117,402,357,876,1273
2017-07-11,6.750859166316276e+20,1144334110300,248,422,1300,243.98358575683577,61.900980880230875,107,362,294,763,1185
2017-07-12,4.939005019415847e+20,836924971467,135,198,638,194.5722043049543,40.328834956709954,97,258,203,558,756
2017-07-13,3.471146030578341e+20,587981880317,138,138,547,121.5636988936989,38.73212842712842,37,202,153,392,530
2017-07-14,3.357387017074977e+20,568514799421,148,121,525,124.46607864357864,36.346608946608946,53,176,150,379,500
2017-07-15,1.976209463132286e+20,334526704461,36,141,289,64.1467352092352,27.486044372294373,12,120,91,223,364
2017-07-16,1.5337451921086415e+20,259535785470,72,104,322,67.2371626984127,20.08756673881674,22,70,81,173,277
2017-07-17,5.7742388840479634e+20,976700151183,178,671,948,182.70669047619046,43.10124573112073,90,353,208,651,1322
2017-07-18,4.8978959733333964e+20,828211845579,190,610,897,161.84986535686537,47.68354942279942,64,271,217,552,1162
2017-07-19,4.038912916044094e+20,682715101097,176,392,1041,146.84741534391534,40.11060894660894,63,209,183,455,847
2017-07-20,4.3958296581832894e+20,742778058317,176,826,856,160.8527471139971,34.438777056277054,74,228,193,495,1321
2017-07-21,3.242585877635366e+20,547734037336,101,629,594,113.96281984681984,31.971271894771892,49,177,139,365,994
2017-07-22,1.5019620079100304e+20,253622675413,114,96,332,59.827063492063495,18.146019119769118,23,73,73,169,265
2017-07-23,1.0846955116562152e+20,183099023108,46,55,217,39.58746392496393,15.16141774891775,15,59,48,122,177
2017-07-24,4.438616684263964e+20,748953520413,138,141,622,164.9074448051948,58.362789682539685,60,222,217,499,640
2017-07-25,4.1733352775463856e+20,703963669586,97,635,720,134.28985675435675,42.44870447607948,65,236,168,469,1104
2017-07-26,2.982110780573606e+20,502858777841,72,105,403,105.39945436507936,31.383085317460317,35,167,133,335,440
2017-07-27,3.722608034509819e+20,627486911004,107,164,535,120.33242784992785,33.27046626984127,60,210,148,418,582
2017-07-28,3.5459327657831976e+20,597497944875,110,220,553,116.62401774151775,28.862715409590407,54,198,146,398,618
2017-07-29,3.2174656162267863e+20,541979783727,203,350,1276,120.02216185666185,39.69264844877345,51,146,164,361,711
2017-07-30,1.908114048262563e+20,321303668494,105,153,477,72.14736721611722,24.521765873015873,29,89,96,214,367
2017-07-31,5.593084243340513e+20,941449048605,202,424,849,179.89838018463018,38.97016774891775,93,338,196,627,1051
2017-08-01,5.6487528886847026e+20,950509302374,253,301,1427,195.89648527398526,40.95966346153846,113,317,203,633,934
2017-08-02,1.3909956382475815e+21,2339644093342,490,1033,3071,448.17629678588605,130.79559410430838,203,792,563,1558,2591
2017-08-03,1.2074413986295993e+21,2030381347667,511,803,2398,404.47124333074333,92.98262937062937,212,651,489,1352,2155
2017-08-04,6.209633072048218e+20,1043789496415,219,1408,1388,214.74634932659933,58.651700216450216,92,344,259,695,2103
2017-08-05,2.0378452876122476e+20,342440391898,82,143,432,73.66851518851519,21.446525974025974,38,95,95,228,371
2017-08-06,1.7526056463188066e+20,294397029726,68,106,327,63.2400974025974,22.522535173160172,22,84,90,196,302
2017-08-07,5.6625403715859127e+20,950838021588,210,352,1006,192.55513093388092,43.78206356143856,96,303,234,633,985
2017-08-08,5.852736074168265e+20,982438174965,235,325,908,195.11220312095313,60.986806457431456,84,325,245,654,979
2017-08-09,5.819675116608856e+19,97649460041,20,38,77,20.497356902356902,6.968961038961039,8,32,25,65,103
2017-08-10,4.3706905497818045e+20,733156850446,106,161,498,157.45092111592112,49.57585137085137,75,205,208,488,649
2017-08-11,3.5212768853390164e+20,590465928007,143,372,792,122.62329304954305,33.97815927128427,54,192,147,393,765
2017-08-12,1.3444778238548147e+20,225380095364,56,75,320,51.469902597402594,17.2398556998557,19,74,57,150,225
2017-08-13,1.4437476506464893e+20,241924057188,49,68,234,50.038777056277056,19.3555284992785,22,74,65,161,229
2017-08-14,4.010016968257462e+20,671715488222,120,328,792,140.8001058201058,39.09397186147186,58,211,178,447,775
2017-08-15,3.158999668294077e+20,528986332128,104,193,499,110.12779313279313,34.14429043179043,35,184,133,352,545
2017-08-16,3.034588189594178e+20,507976441694,85,242,548,114.550291005291,31.612839105339106,41,166,131,338,580
2017-08-17,3.026898175606862e+20,506504262506,87,135,464,99.19907647907648,26.910602453102452,46,166,125,337,472
2017-08-18,3.019061778079046e+20,505028593250,110,135,854,100.19364838864838,24.765324675324674,49,175,112,336,471
2017-08-19,1.177515992160455e+20,196911550589,28,128,209,45.83504329004329,18.11843344155844,10,57,64,131,259
2017-08-20,1.124054730815368e+20,187903924946,55,126,290,37.29580447330447,11.709655483405482,14,65,46,125,251
2017-08-21,3.562602772077001e+20,595317718857,124,169,965,132.84176166426167,28.513037518037518,71,171,154,396,565
2017-08-22,2.6189615739625393e+20,437491887203,63,143,542,92.81900974025974,35.603771645021645,32,130,129,291,434
2017-08-23,3.59247452977521e+20,599896421966,111,280,589,124.93609698172199,37.399256854256855,49,194,156,399,679
2017-08-24,3.062460283276321e+20,511218634144,95,174,416,106.78532227032227,24.96598665223665,51,157,132,340,514
2017-08-25,3.1988088015831964e+20,533801960758,79,168,365,113.01713804713805,32.24250360750361,50,178,127,355,523
2017-08-26,1.550463250761596e+20,258645540074,59,84,327,62.10009018759019,23.01728896103896,19,76,77,172,256
2017-08-27,1.3797416240568215e+20,230087354799,54,60,143,55.51717532467533,16.66323593073593,17,68,68,153,213
2017-08-28,2.1832205850040674e+20,363950098726,65,140,494,68.42669949494949,21.12941883116883,25,133,84,242,382
2017-08-29,2.7617531200662605e+20,460228827565,73,229,623,96.80141414141414,29.89020202020202,42,141,123,306,535
2017-08-30,3.0969172957479954e+20,515906658266,84,2144,619,111.57863852813853,42.732223665223664,31,157,155,343,2487
2017-08-31,2.9265805461573177e+20,487357649177,89,198,504,97.40050865800866,19.334062950937952,42,166,116,324,522
2017-09-01,2.5662329569597093e+20,427212894181,89,150,493,87.71492905242906,22.710068542568543,39,134,111,284,434
2017-09-02,1.4011314787225502e+20,233174998621,52,73,269,53.836190476190474,22.815889850889853,10,68,77,155,228
2017-09-03,1.039968005998917e+20,173010791460,28,70,166,45.4083658008658,18.514704184704186,10,51,54,115,185
2017-09-04,1.1670262919897006e+20,194083786702,29,94,425,44.67171717171717,17.122050865800865,7,64,58,129,223
2017-09-05,2.5522868186818376e+20,424302722390,64,210,489,93.5145689033189,28.114606782106783,36,127,119,282,492
2017-09-06,2.3450364306134683e+20,389718283679,87,123,389,80.88073653198653,26.02869588744589,38,124,97,259,382
2017-09-07,2.8260512428940172e+20,469494824120,85,109,393,92.73617724867725,21.673069985569985,39,160,113,312,421
2017-09-08,2.238160638563883e+20,371704146539,42,78,305,70.45886904761905,23.54968163780664,30,131,86,247,325
2017-09-09,1.2237592449184925e+20,203169415547,28,74,158,41.88739297739298,15.34676406926407,12,73,50,135,209
2017-09-10,1.6505088211251387e+20,273919162084,42,154,350,54.76985209235209,22.97642316017316,13,96,73,182,336
2017-09-11,5.207738924998781e+20,863953446654,192,247,1061,171.33782888407887,62.98412518037518,76,290,208,574,821
2017-09-12,4.810216927669118e+20,797767044803,166,303,728,159.44782323232323,40.466015022675734,69,266,195,530,833
2017-09-13,3.622794727566545e+20,600619311821,133,246,723,114.3054791967292,32.75766414141414,50,213,136,399,645
2017-09-14,6.60366500586678e+20,1094426668961,304,366,1383,209.69612734487734,70.22154852092352,75,375,277,727,1093
2017-09-15,3.7437637614994647e+20,620258293003,121,136,688,132.47604437229438,37.5464448051948,61,191,160,412,548
2017-09-16,1.3635265190969649e+20,225834251643,52,41,168,49.38551226551227,20.83741341991342,10,72,68,150,191
2017-09-17,1.3004562870239986e+20,215308695323,46,93,321,46.28934343434344,21.072723665223666,9,72,62,143,236
2017-09-18,4.9128755322449966e+20,813102966410,180,371,1152,186.5470677008177,72.35424783549783,55,229,256,540,911
2017-09-19,5.033094949368962e+20,832724075328,213,335,976,168.3745860990861,51.04146127946128,81,254,218,553,888
2017-09-20,5.071619953573802e+20,838797922924,174,331,1045,172.57556036556036,47.98425144300144,76,278,203,557,888
2017-09-21,5.556206167642976e+20,918659612207,181,382,871,179.7057172919673,43.9677380952381,80,312,218,610,992
2017-09-22,5.075601410025264e+20,838892848229,146,238,733,171.20511038961038,33.68062974987975,89,276,192,557,795
2017-09-23,1.7228723433674542e+20,284666287725,44,148,346,65.35383297258298,20.611796536796536,19,90,80,189,337
2017-09-24,1.5046722349544954e+20,248531952360,63,89,220,45.76823953823954,19.402503607503608,12,91,62,165,254
2017-09-25,3.868265333123619e+20,638692661474,109,188,612,129.47113385688385,29.159076719576717,75,201,148,424,612
2017-09-26,4.0523056099986276e+20,668857223086,158,325,888,126.12128246753247,30.63242965367965,71,225,148,444,769
2017-09-27,3.9625750548307876e+20,653829530204,130,124,538,138.63611832611832,39.51191017316017,54,195,185,434,558
2017-09-28,3.4709212552670885e+20,572510501572,88,204,541,116.48403078403078,28.828535353535354,52,204,124,380,584
2017-09-29,4.166721389606105e+20,687051127535,138,255,668,142.78780152717653,43.44623887686387,61,226,169,456,711
2017-09-30,1.5173763860129225e+20,250123677903,32,223,359,52.61669913419914,24.700494227994227,12,84,70,166,389
2017-10-01,1.2802455090535163e+20,210960327891,34,35,164,48.04658219095719,17.78376893939394,16,66,58,140,175
2017-10-02,4.78495400849444e+20,788142885049,227,425,1159,159.21494838494837,41.24305164742665,77,262,184,523,948
2017-10-03,1.0479262532522407e+21,1725561133688,417,673,1779,352.4685428691679,84.93820316257816,171,573,401,1145,1818
2017-10-04,6.060990952426097e+20,997714037963,213,301,1021,197.1690885040885,50.86316738816738,83,340,239,662,963
2017-10-05,3.5995974208655465e+20,592333235077,89,162,454,126.91521765271766,34.39632485569985,58,179,156,393,555
2017-10-06,5.653683400996377e+20,930005495374,235,399,1419,192.54766212953712,62.11081619769119,72,286,259,617,1016
2017-10-07,3.171620167383576e+20,521554218439,132,214,581,126.18285533910534,36.16329906204906,52,145,149,346,560
2017-10-08,2.430061210685809e+20,399478442257,99,146,480,107.26327727827727,48.13137543012543,25,101,139,265,411
2017-10-09,6.164939052298165e+20,1013080703542,270,373,1295,232.44239898989898,64.65351551226551,104,303,265,672,1045
2017-10-10,6.460959818518667e+20,1061381107769,288,277,1357,219.15432937432936,63.174938394938394,81,358,265,704,981
2017-10-11,4.4253224504753534e+20,726726366611,176,176,712,168.33002317127318,42.24201950826951,73,209,200,482,658
2017-10-12,3.8944003689545603e+20,639315769284,113,117,403,131.92568093943095,46.178758325008324,44,194,186,424,541
2017-10-13,3.206698811704346e+20,526257063420,149,153,607,114.99237012987012,32.21275072150072,41,157,151,349,502
2017-10-14,2.5093282448061107e+20,411678995412,71,149,279,86.67215127465127,24.648748196248196,33,126,114,273,422
2017-10-15,1.8022808690239318e+20,295581379335,67,54,281,58.08320716320716,22.450238095238095,19,89,88,196,250
2017-10-16,3.265747688357578e+20,535397908183,118,174,462,115.9321675084175,42.55790494227994,38,164,153,355,529
2017-10-17,3.8007570971691896e+20,622905954986,97,140,469,134.34110606060605,43.81825,51,186,176,413,553
2017-10-18,4.8057447166276285e+20,787349739204,129,132,614,175.88728174603173,62.60424963924964,61,231,230,522,654
2017-10-19,4.236637165311885e+20,693873389416,121,136,468,149.32110245310244,41.163156806156806,65,211,184,460,596
2017-10-20,4.017189772243873e+20,657709316471,137,186,645,138.14917027417027,42.8419705988456,42,223,171,436,622
2017-10-21,2.0277546554082427e+20,331889132685,33,92,212,82.61055134680134,25.656414742664744,23,78,119,220,312
2017-10-22,3.089032822276108e+20,505407997969,147,253,667,109.92458994708994,33.43135642135642,28,163,144,335,588
2017-10-23,5.19344333007656e+20,849435428406,176,244,822,171.8855881063381,54.71870024420024,63,284,216,563,807
2017-10-24,4.0788456421432754e+20,666912316812,140,203,628,140.0114242146742,46.81057142857143,50,215,177,442,645
2017-10-25,5.8069042330219604e+20,949124584371,185,233,705,187.59812349687348,55.51276966089466,93,314,222,629,862
2017-10-26,4.414498034280699e+20,721312952522,127,130,515,157.93780483405484,43.47883658008658,67,214,197,478,608
2017-10-27,5.5064673784616655e+20,899430057417,196,269,895,171.63215626965626,40.67541833166833,95,298,203,596,865
2017-10-28,1.4603192347184017e+20,238452649608,39,76,258,40.631598124098126,14.58181277056277,13,95,50,158,234
2017-10-29,1.923195707824568e+20,313930233426,34,123,283,69.0335471010471,25.948027805527804,16,105,87,208,331
2017-10-30,3.4409619971138775e+20,561485537398,57,224,551,104.50562229437229,30.515086580086578,41,191,140,372,596
2017-10-31,4.1733905424549315e+20,680765957657,151,1096,886,166.08527272727272,48.27058495670995,48,190,213,451,1547
2017-11-01,1.438661450115227e+21,2345853168570,638,969,3420,473.02422526547525,111.82117514430014,242,774,538,1554,2523
2017-11-02,1.4604094407614658e+21,2380681498005,603,861,2545,515.228325998076,90.84140824915825,311,737,529,1577,2438
2017-11-03,6.095968131232917e+20,993392619003,218,1624,1076,221.50248015873015,54.28531655844156,109,301,248,658,2282
2017-11-04,2.2242365360259652e+20,362350325248,106,198,456,67.61025853775854,18.31435606060606,35,121,84,240,438
2017-11-05,1.9098977560145422e+20,311035515594,76,137,455,62.095221537721535,20.40593795093795,15,106,85,206,343
2017-11-06,3.98846138102877e+20,649291368402,151,147,675,145.15456204906204,35.08059126984127,68,180,182,430,577
2017-11-07,4.258998433662838e+20,693117688622,157,209,756,138.6488161976912,36.15839880952381,78,226,155,459,668
2017-11-08,2.7383103855040037e+20,445492724505,87,141,441,90.14121452621453,19.220882034632034,46,144,105,295,436
2017-11-09,3.1108849939424136e+20,505928994342,110,155,612,101.33728805916306,29.397232142857142,49,159,127,335,490
2017-11-10,3.539477517748793e+20,575433845207,119,162,637,122.24049147017004,34.62811095253952,56,178,147,381,543
2017-11-11,1.7750293833794106e+20,288487478413,64,185,365,52.01872113997114,20.60661435786436,26,100,65,191,376
2017-11-12,1.7199741246102064e+20,279441848902,87,133,542,67.701488997114,23.59273118085618,22,81,82,185,318
2017-11-13,6.212962576586243e+20,1009070333690,204,356,1150,216.10810640417782,64.95989344980416,80,312,276,668,1024
2017-11-14,4.382376178062228e+20,711525262981,122,288,719,143.07333453583453,36.13363997113997,75,227,169,471,759
2017-11-15,5.017025487479542e+20,814297259862,192,182,955,170.72382143782144,48.08004499667,79,248,212,539,721
2017-11-16,5.6428387050123815e+20,915569752951,238,318,1097,196.57829485329486,54.56823683261183,71,292,243,606,924
2017-11-17,1.9449833683388636e+21,3154807597084,1029,3241,6541,761.4021395086395,191.68329413179413,341,784,963,2088,5329
2017-11-18,4.044143370041689e+20,655774270378,197,243,893,148.02113846801348,45.01715818903318,52,165,217,434,677
2017-11-19,2.9364541471003895e+20,475993539397,187,310,987,117.34513528138528,33.27896915584416,42,127,146,315,625
2017-11-20,5.21334727994461e+20,844754635636,197,258,918,198.1587968975469,44.912853535353534,86,225,248,559,817
2017-11-21,5.635194486691919e+20,912809830626,263,423,1607,213.0780584798799,61.81710899814471,81,245,278,604,1027
2017-11-22,4.041302391907308e+20,654417701206,230,353,1330,145.47052387823817,45.04364124235553,65,180,188,433,786
2017-11-23,2.278117257163471e+20,368790281632,79,93,342,89.49342412217412,20.276593614718614,51,87,106,244,337
2017-11-24,1.8308599598818433e+20,296262757959,122,454,519,74.6895294189937,24.420249948464235,38,61,97,196,650
2017-11-25,1.6819193913546205e+20,272090378497,88,188,462,62.01591197691197,20.184949314574315,20,61,99,180,368
2017-11-26,2.1592913411687786e+20,349202396364,84,144,428,93.55047789247789,35.604621753246754,22,64,145,231,375
2017-11-27,3.4226804332788574e+20,553316661108,105,202,626,129.05724747474747,37.476738816738816,55,140,171,366,568
2017-11-28,3.601727180963181e+20,582073332732,97,226,548,121.74926803751804,25.364094757094755,67,170,148,385,611
2017-11-29,4.454730843462753e+20,719694507494,119,302,697,151.122578712293,43.42624670171099,62,217,197,476,778
2017-11-30,4.053784370974077e+20,654715294779,142,410,887,131.47411075036075,39.685012626262626,58,208,167,433,843
2017-12-01,2.772296771901802e+20,447591858071,107,224,598,93.9863222888223,25.33378427128427,33,130,133,296,520
2017-12-02,1.8738775579209345e+20,302443717303,85,106,372,79.66258556258556,24.34420621045621,25,71,104,200,306
2017-12-03,1.7527619011287482e+20,282801240364,58,91,210,78.55475288600289,22.286396103896102,19,59,109,187,278
2017-12-04,3.272494675087012e+20,527825759049,124,110,466,120.48281902356902,31.95627398989899,48,143,158,349,459
2017-12-05,3.5926753733708644e+20,579279850875,166,204,676,119.81608873599944,33.04139412835841,44,182,157,383,587
2017-12-06,3.922587253352432e+20,632254787127,131,151,669,141.7348798100048,41.04453878066378,49,183,186,418,569
2017-12-07,3.8301017319892025e+20,617161410722,143,214,814,152.55574555074554,51.1476449013949,49,148,211,408,622
2017-12-08,3.850403014953352e+20,620223100990,165,312,745,150.3365903078403,59.44568001443001,36,154,220,410,722
2017-12-09,2.0668319859793107e+20,332820808845,36,44,172,93.39373299319728,28.29234410430839,26,64,130,220,264
2017-12-10,1.7574318012216862e+20,282912579462,31,32,136,72.50277597402598,27.406295093795094,17,57,113,187,219
2017-12-11,4.62601068693313e+20,744399496770,190,277,1371,179.9668563149813,58.20947850760351,63,184,245,492,769
2017-12-12,6.264337112476266e+20,1007717528130,184,298,1111,234.64460772560773,58.654454323454324,103,269,294,666,964
2017-12-13,4.1870934970769074e+20,673359651722,119,136,664,146.41133273208274,50.62256998556998,46,199,200,445,581
2017-12-14,4.904243835226794e+20,788409306216,261,337,1061,174.69561696636697,51.62965713453213,68,234,219,521,858
2017-12-15,4.162103120153212e+20,668897329763,204,830,1094,166.52608739034335,43.563448000412286,71,164,207,442,1272
2017-12-16,1.978192867510437e+20,317819137836,70,86,350,83.21890497729784,23.597083055833057,23,78,109,210,296
2017-12-17,1.8470623667138318e+20,296649053429,71,154,356,75.30378427128427,25.113905122655122,20,60,116,196,350
2017-12-18,3.309038007132425e+20,531274689924,93,150,632,123.57707287157287,41.38793253968254,31,152,168,351,501
2017-12-19,4.4233033500861006e+20,709923372848,108,264,763,154.09360209235209,50.290419372294366,40,193,236,469,733
2017-12-20,4.047512309969349e+20,649410417299,113,170,750,161.35962686189472,41.23780163883735,40,174,215,429,599
2017-12-21,3.369542015959286e+20,540450227735,143,472,677,132.86443559152488,39.007928159142445,47,138,172,357,829
2017-12-22,3.181929807949832e+20,510200504657,121,113,587,124.51666125541125,32.30838203463203,55,124,158,337,450
2017-12-23,1.4734738868761328e+20,236188611008,33,100,293,61.623800505050504,18.509203643578644,11,57,88,156,256
2017-12-24,1.502393765306307e+20,240744619571,33,46,266,60.60073953823954,22.011186868686867,14,56,89,159,205
2017-12-25,1.0492351466132701e+20,168076397418,29,56,247,48.0912012987013,18.42052308802309,6,33,72,111,167
2017-12-26,2.6951577493942085e+20,431575535742,61,147,553,95.64569444444444,25.72635101010101,36,124,125,285,432
2017-12-27,4.777465634424279e+20,764765318772,218,318,1082,157.20549422799422,38.35210317460317,64,240,201,505,823
2017-12-28,3.539436145904991e+20,566411014000,181,190,842,139.55104473304473,40.966310966810966,54,140,180,374,564
2017-12-29,3.190475254106973e+20,510404243968,118,210,820,125.62709872534873,40.10232918470418,34,125,178,337,547
2017-12-30,1.6478916260313304e+20,263546083499,40,67,315,65.08559343434344,23.78011002886003,16,70,88,174,241
2017-12-31,1.4779950021038503e+20,236296402798,37,84,349,58.89501823573252,20.495022675736962,13,58,85,156,240
2018-01-01,1.2416195452852312e+20,198439898392,30,64,249,44.22379725829726,14.837930735930735,13,54,64,131,195
2018-01-02,2.8446172935635272e+20,454471453565,86,145,651,101.25963841713842,36.03310876623377,40,131,129,300,445
2018-01-03,4.5059119854233027e+20,719625926027,308,467,1763,152.35390007215008,22.97706884319384,96,214,165,475,942
2018-01-04,8.151137216877536e+20,1301447498115,457,542,1928,313.29947210197207,60.509326298701296,179,336,344,859,1401
2018-01-05,9.113609350469272e+19,145456695437,25,107,171,37.449675324675326,12.461936327561327,15,30,51,96,203
2018-01-06,1.4244127842774604e+20,227285893332,112,146,643,53.536210317460316,17.113757215007215,20,66,64,150,296
2018-01-07,1.900006543258102e+20,303066680861,104,129,365,67.7789393939394,20.812023809523808,22,87,91,200,329
2018-01-08,5.464768621922832e+20,871370347121,330,734,2060,200.97150432900432,72.87814754689755,80,215,280,575,1309
2018-01-09,4.6109728070541764e+20,735019120969,193,249,1121,150.9611924186924,42.7436066017316,70,227,188,485,734
2018-01-10,3.195625765925329e+20,509238206769,172,335,959,104.77352182539683,36.92176857864358,44,156,136,336,671
2018-01-11,4.2910912753077735e+20,683572161803,210,549,1482,158.36307740275598,48.16322396452753,71,178,202,451,1000
2018-01-12,2.9696151724614405e+20,472917654926,127,275,781,99.6522117003367,32.50506403318903,40,142,130,312,587
2018-01-13,1.6091129329387038e+20,256177352541,123,152,611,61.417397186147184,19.937449494949494,16,71,82,169,321
2018-01-14,1.6097607821188153e+20,256192798473,90,114,478,57.491584387834386,20.422209595959597,18,74,77,169,283
2018-01-15,1.6103494154486012e+20,256206832583,55,161,373,56.29233525733525,13.843008658008658,21,80,68,169,330
2018-01-16,3.031439851260186e+20,482124679983,107,199,781,107.00700757575757,35.368970057720055,44,139,135,318,517
2018-01-17,3.995771151347285e+20,635288462199,215,348,1234,148.316933982684,38.66486075036075,65,171,183,419,767
2018-01-18,3.9113495384530217e+20,621676179343,185,358,1161,143.44939291726791,38.79165115440115,58,163,189,410,768
2018-01-19,2.5863033286871473e+20,410936554472,102,209,504,89.8717261904762,28.116239177489177,35,126,110,271,480
2018-01-20,1.6420519328169273e+20,260829184419,124,145,505,63.269616402116405,23.330661976911976,20,70,82,172,317
2018-01-21,1.537636487628949e+20,244162541503,80,92,516,57.68808802308802,19.9954816017316,16,73,72,161,253
2018-01-22,2.8568111885896745e+20,453473343695,166,200,957,102.93665667665668,34.751978299478296,32,136,131,299,499
2018-01-23,5.811279574747051e+20,922163366183,323,464,1819,198.7168133288669,47.111296854600425,82,289,237,608,1072
2018-01-24,3.489983793616807e+20,553632463286,166,370,899,108.31343524531025,29.015981713392424,54,172,139,365,735
2018-01-25,4.3427913017137843e+20,688671291416,259,310,1002,135.63798984745412,30.178052076891362,82,207,165,454,764
2018-01-26,3.186395080343875e+20,505151625139,104,320,781,100.23990957190956,31.493691919191917,55,156,122,333,653
2018-01-27,1.483709665768366e+20,235143816023,54,117,281,52.9149673012173,14.321266233766234,20,68,67,155,272
2018-01-28,1.7619156791849202e+20,279152978520,68,91,412,70.89356421356422,13.690808982683983,39,66,79,184,275
2018-01-29,3.784052123538779e+20,599308647834,138,195,760,133.79244498556997,42.07375,48,179,168,395,590
2018-01-30,3.0953731000419156e+20,490093142285,89,90,427,110.96156721981721,24.605054653679655,43,164,116,323,413
2018-01-31,3.614324615636978e+20,572062999183,135,276,861,126.79141747141747,45.785870518370515,45,158,174,377,653
2018-02-01,3.8746278315844266e+20,613067655779,140,308,909,129.85467528172884,27.888725005153574,69,184,151,404,712
2018-02-02,3.338759976128343e+20,528116811956,153,369,828,123.0763294681509,36.22356965058751,59,132,157,348,717
2018-02-03,1.631566531425744e+20,258001523014,77,377,818,59.677319624819624,18.880185786435785,24,72,74,170,547
2018-02-04,1.4882327314420233e+20,235251654318,60,195,548,52.26273027898028,19.498237734487734,18,77,60,155,350
2018-02-05,2.958366589672303e+20,467494127915,96,251,723,108.0963058006808,31.30301497113997,37,138,133,308,559
2018-02-06,3.776293577664615e+20,596545999753,155,165,801,144.25496632996632,36.25675943104515,64,158,171,393,558
2018-02-07,1.0631891075370305e+21,1678935517772,568,809,3072,350.1460352742495,94.31202019210947,168,514,424,1106,1915
2018-02-08,1.074067624032919e+21,1695706342921,509,888,2805,366.04180486576917,82.629438576635,200,496,421,1117,2005
2018-02-09,5.5409272146293463e+20,874474944457,250,386,1104,191.3881343193843,45.11434974747475,85,260,231,576,962
2018-02-10,2.2035952171857658e+20,347681013148,123,122,530,86.45382610445111,18.84779310966811,43,87,99,229,351
2018-02-11,2.0023732394525924e+20,315817972893,85,111,468,83.73468404280904,23.26623196248196,25,85,98,208,319
2018-02-12,3.158748866749283e+20,498048313171,128,218,582,113.21844432419432,27.815258177008175,47,151,130,328,546
2018-02-13,3.420079152275753e+20,539077457016,121,149,517,118.64169973544973,32.53828643578643,59,149,147,355,504
2018-02-14,3.4695587334891864e+20,546701317026,141,202,620,123.11169011544011,36.08965638528139,62,147,151,360,562
2018-02-15,2.8924116177788106e+20,455610959058,124,88,452,100.709901996152,20.867891414141415,59,127,114,300,388
2018-02-16,3.288931391740369e+20,517906961099,199,149,595,117.84392490842491,36.92318985181485,56,138,147,341,490
2018-02-17,1.4665391420506487e+20,230867933918,81,76,332,47.326904761904764,18.758353174603176,13,71,68,152,228
2018-02-18,1.6987632948303954e+20,267336628548,136,113,495,59.26022847522847,19.981248196248195,18,77,81,176,289
2018-02-19,2.2111755741270694e+20,347861742936,77,132,479,70.35661916786917,18.001006493506495,34,110,85,229,361
2018-02-20,3.139299193128625e+20,493718091891,127,144,442,101.76160894660894,29.55477453102453,36,154,135,325,469
2018-02-21,4.2034186764474856e+20,660860524571,194,262,818,136.40639763014764,21.94591797091797,89,205,141,435,697
2018-02-22,4.872069064147765e+20,765732005339,251,266,883,166.328348701563,45.68795064062921,73,234,197,504,770
2018-02-23,4.786847713882847e+20,752100655241,267,291,1108,162.43109523809522,43.23453336940837,73,214,208,495,786
2018-02-24,2.5925416702825654e+20,407218783204,157,187,1022,82.9527187049062,21.105748106060606,38,118,112,268,455
2018-02-25,2.070983812472343e+20,325186786260,99,173,711,66.86295162509448,19.28646477530406,28,103,83,214,387
2018-02-26,3.804665455203251e+20,597222438023,181,250,829,117.94211683158112,42.26433815192743,50,185,158,393,643
2018-02-27,3.670541456575737e+20,575980983064,175,169,749,133.61128697691197,42.20166320947571,58,164,157,379,548
2018-02-28,3.565311421534764e+20,559294918806,132,155,597,101.45651515151515,30.08226551226551,54,180,134,368,523
2018-03-01,3.9252972271442946e+20,615564543291,181,191,737,132.35193635200778,40.853214921982776,54,180,171,405,596
2018-03-02,3.975249541651996e+20,623199674135,191,175,631,128.34292207792208,40.64306998556999,60,186,164,410,585
2018-03-03,2.376247286173263e+20,372418718827,159,80,452,84.75823893698893,19.793120490620492,41,104,100,245,325
2018-03-04,1.600970016594035e+20,250827870393,123,202,585,66.26017961205461,17.80930826118326,29,54,82,165,367
2018-03-05,3.2128402481985035e+20,503204457129,141,142,560,110.98648809523809,28.075165644540643,47,141,143,331,473
2018-03-06,3.301399185517395e+19,51691538149,12,26,72,9.82388888888889,1.2712500000000002,5,17,12,34,60
2018-03-07,3.14727673402245e+20,492619456320,156,163,670,108.98296536796536,37.30593073593074,46,138,140,324,487
2018-03-08,4.023050273870056e+20,629494672296,270,348,1089,128.90340051152552,33.68133387445887,59,199,156,414,762
2018-03-09,4.724344950615453e+20,739010958476,251,256,1088,156.60457181707181,27.46287157287157,100,207,179,486,742
2018-03-10,2.2949724121268856e+20,358881460058,138,154,554,78.37564604377104,18.737174422799423,38,107,91,236,390
2018-03-11,2.607148511396749e+20,407567037438,175,194,739,104.36120941558441,20.654839466089467,60,88,120,268,462
2018-03-12,5.839144931135685e+20,912517048266,433,280,1105,189.0542745711079,52.43031998556998,93,261,246,600,880
2018-03-13,4.6048662630577557e+20,719407509915,298,245,894,150.84172789247788,43.18703637566138,79,208,186,473,718
2018-03-14,6.905188153853878e+20,1078416511484,409,426,1774,226.3033701635666,44.75133765837337,130,322,257,709,1135
2018-03-15,5.0564113258151674e+20,789459591954,243,282,930,151.45474538754897,39.024352478870334,78,262,179,519,801
2018-03-16,4.044750515394591e+20,631300881346,201,207,741,143.22036375661375,38.72811387686387,74,166,175,415,622
2018-03-17,2.3594940617841138e+20,368152785902,103,129,373,83.46382524221809,22.728231034838178,29,113,100,242,371
2018-03-18,1.911647090490443e+20,298188873236,85,160,455,75.517784992785,23.70022095959596,28,75,93,196,356
2018-03-19,5.2398054093575206e+20,817031077175,321,380,1657,181.24861241382075,37.62128156565657,107,230,200,537,917
2018-03-20,3.982465445709281e+20,620794044740,250,182,1017,137.90060326908542,35.05973832714904,77,176,155,408,590
2018-03-21,5.585403461183799e+20,870380000910,296,541,1893,172.8555301087801,45.96179888167388,92,276,204,572,1113
2018-03-22,4.962262425588623e+20,773037722524,297,378,1291,172.08604772211913,87.16199482065554,82,173,253,508,886
2018-03-23,5.8925495507743854e+20,917656818543,321,581,1594,202.90125036075037,78.36033513708514,102,256,245,603,1184
2018-03-24,2.688239769806911e+20,418522248510,187,266,1009,95.54837692400191,16.7138952020202,69,94,112,275,541
2018-03-25,2.2198162923140547e+20,345490083762,153,167,595,77.3139457070707,15.04059568903319,46,89,92,227,394
2018-03-26,6.01651283042855e+20,936078353116,318,280,1224,194.8987251082251,68.6508976070226,92,284,239,615,895
2018-03-27,1.2996923989515617e+21,2021443660702,788,1286,4634,440.407046847773,99.58785428559536,256,558,514,1328,2614
2018-03-28,1.8052916824945648e+21,2807026770138,1085,1494,5544,611.3514919555753,154.3849517539339,321,804,719,1844,3338
2018-03-29,1.6345624792701988e+21,2540775635632,979,1354,5269,591.6684740805931,103.4050503590325,375,649,645,1669,3023
2018-03-30,5.8977471020728536e+20,916491902853,388,292,1514,218.80196987932703,44.85354766529766,130,219,253,602,894
2018-03-31,5.0668488083995165e+20,787130770994,364,428,1724,185.8186186868687,33.3958455988456,124,180,213,517,945
2018-04-01,5.775031729652769e+20,896811285711,408,379,2606,225.24478315996174,62.981744555048124,110,216,263,589,968
2018-04-02,1.6840651751864488e+21,2614442076798,826,1220,5389,568.442097014097,109.18261468623969,320,733,664,1717,2937
2018-04-03,1.6042254927457094e+21,2489722345287,788,1498,5993,523.4564425640497,120.46218358493358,269,725,641,1635,3133
2018-04-04,1.2818785661259557e+21,1988842142561,614,775,3306,414.6518477917585,101.59406295093794,205,603,498,1306,2081
2018-04-05,1.0270739652333015e+21,1592994898395,512,725,2988,355.0578361486397,83.1367334847692,194,431,421,1046,1771
2018-04-06,6.875836344950329e+20,1066117195057,277,503,1444,210.76838834776333,51.137225378787875,110,340,250,700,1203
2018-04-07,3.0460569742537176e+20,472162499559,127,205,650,94.25335644910645,13.206618506493506,62,142,106,310,515
2018-04-08,2.948948931881203e+20,456958913665,243,349,1318,95.01123973248973,24.08060488122988,46,132,122,300,649
2018-04-09,5.40846999344421e+20,837807208883,282,408,1708,159.3321966854694,39.43773709497573,89,263,198,550,958
2018-04-10,3.5907845995837476e+20,556035741772,119,224,761,104.97809764309764,51.786425865800865,40,176,149,365,589
2018-04-11,7.105053667373198e+20,1099936531317,448,646,2585,243.99793131207417,57.95669078540507,147,287,288,722,1368
2018-04-12,8.180726142435876e+20,1266065573796,468,1099,3004,278.1810760020403,100.3602438157081,130,335,366,831,1930
2018-04-13,1.0645629081097276e+21,1647042182988,685,931,4173,402.0562809227809,83.83698761423761,211,391,479,1081,2012
2018-04-14,3.428335942615761e+20,530252469411,255,435,1635,133.00712028976315,29.371181910681912,77,126,145,348,783
2018-04-15,3.76466304708125e+20,582091521576,231,204,1269,154.5602198172198,41.922274943310654,90,117,175,382,586
2018-04-16,6.694325436526391e+20,1034724103308,407,687,2277,260.9056058201058,38.95595472582973,164,248,267,679,1366
2018-04-17,1.1134623311645483e+21,1720564792718,782,951,4510,389.0786814296814,63.15072613035113,255,455,419,1129,2080
2018-04-18,8.642577490370188e+20,1335074541870,559,561,3198,297.14420666833166,57.93785335497835,180,360,336,876,1437
2018-04-19,6.119238090250474e+20,944971689039,400,579,2408,223.1410563973064,44.92937950937951,117,241,262,620,1199
2018-04-20,5.272337384233686e+20,813940194971,348,448,2057,178.6057928229178,34.53588776501277,110,213,211,534,982
2018-04-21,2.2716588070884678e+20,350592610554,219,210,951,90.72707690854119,19.893713392427678,44,75,111,230,440
2018-04-22,2.0156134033678765e+20,310978303094,123,234,973,77.35333513708514,24.258851783137498,32,78,94,204,438
2018-04-23,6.276437299110927e+20,968052134869,380,528,2787,192.91561836311837,47.91949585137085,90,296,249,635,1163
2018-04-24,4.746127897845255e+20,731797294561,290,284,1612,173.18795001295,50.28260642135642,72,185,223,480,764
2018-04-25,5.094062491646979e+20,785201925796,260,548,1625,179.03039357864358,39.31856610750361,100,201,214,515,1063
2018-04-26,5.501610290419489e+20,847760856439,378,443,2304,178.7690667804418,39.63938331113331,107,244,205,556,999
2018-04-27,6.473669497360507e+20,997242381407,453,377,2019,232.0194747197247,51.0502842019092,126,265,263,654,1031
2018-04-28,3.2082865251383784e+20,494074043094,213,680,1747,118.92470463795463,17.232738566988566,66,141,117,324,1004
2018-04-29,2.8925472064679536e+20,445303511948,252,297,1246,116.68745413977557,24.61055445546517,62,110,120,292,589
2018-04-30,5.4601054280258414e+20,840327128551,352,801,1979,190.27414006364006,50.37161159211159,97,239,215,551,1352
2018-05-01,6.473328350450161e+20,995945412859,491,572,2600,229.09784491698778,40.23379642117142,145,238,270,653,1225
2018-05-02,2.188779536666928e+21,3366304495053,1925,2519,11078,752.2393624365053,154.99585779300065,432,902,873,2207,4726
2018-05-03,2.5980610074849103e+21,3994884811132,1991,3000,11816,972.2202280616209,125.3423300452854,650,971,998,2619,5619
2018-05-04,1.32485053378579e+21,2036463672286,846,972,4951,487.310640828748,88.30895464852607,325,456,554,1335,2307
2018-05-05,6.025909094856516e+20,925991697739,586,477,3091,227.25384198143126,34.371243944547516,151,208,248,607,1084
2018-05-06,6.325967059765423e+20,971810686325,661,586,3821,236.79625533263032,43.216834679209676,148,226,263,637,1223
2018-05-07,1.2736553557440064e+21,1955949537070,881,1209,6225,464.32864932025643,97.21648424326995,266,471,545,1282,2491
2018-05-08,8.76560696109182e+20,1345740802864,592,522,3226,314.73764863839864,51.885354111166606,188,340,354,882,1404
2018-05-09,7.675367730559029e+20,1177975626881,503,751,3760,264.53482889696284,57.648289796513005,147,304,321,772,1523
2018-05-10,8.413911303163532e+20,1290957665903,584,680,2992,301.0436791125541,62.51035858585858,160,323,363,846,1526
2018-05-11,4.1490933864897944e+20,636366279190,404,240,1611,155.70630531505532,31.827844215969215,89,153,175,417,657
2018-05-12,4.896705103352108e+20,750853354578,327,239,2155,176.91694964757465,41.128112304362304,84,182,226,492,731
2018-05-13,3.4349809022274044e+20,526544392671,332,539,2240,133.86584806397306,23.489893578643578,83,115,147,345,884
2018-05-14,1.1314908146657809e+21,1733884962943,632,905,4103,365.2111063751064,62.3312101972102,207,527,402,1136,2041
2018-05-15,1.192669842032982e+21,1827090113146,801,1022,4943,426.50867155992154,73.27418951418952,262,475,460,1197,2219
2018-05-16,9.070296584656437e+20,1389092548855,636,729,3523,321.0224614360507,55.45744167340596,192,362,356,910,1639
2018-05-17,7.198993560535837e+20,1102176232913,467,659,2683,246.81066022998166,54.387552443588156,144,281,297,722,1381
2018-05-18,7.102032254257479e+20,1086976145489,458,563,2653,243.3414190901691,36.6877671055796,145,301,266,712,1275
2018-05-19,3.392625773903425e+20,519090392859,215,336,1235,118.79478992303991,25.77143722943723,68,126,146,340,676
2018-05-20,4.182444670616481e+20,639739105724,497,718,3523,170.2940339105339,36.34917676767677,88,134,197,419,1137
2018-05-21,1.1463630499167349e+21,1752896799845,740,986,4523,403.1648819507212,55.68054986944272,259,465,424,1148,2134
2018-05-22,1.0089093966437106e+21,1542266068691,825,934,4420,350.73607939315974,77.23705170523921,197,409,404,1010,1944
2018-05-23,1.0342641281956874e+21,1580531982122,618,949,4798,374.8444347583633,76.12218626611484,218,378,439,1035,1984
2018-05-24,7.587021367757655e+20,1159114430797,439,549,2896,287.2239822029822,36.58450086322407,185,271,303,759,1308
2018-05-25,7.930014764899465e+20,1211112419733,781,1431,3185,289.5747943861694,57.10025426887927,154,308,331,793,2224
2018-05-26,3.861322718930185e+20,589551407624,474,496,3061,150.70396233396232,36.185959595959595,79,136,171,386,882
2018-05-27,4.18303428510887e+20,638464328255,314,239,1447,157.7808615921116,34.30035173160173,86,146,186,418,657
2018-05-28,3.694040417855653e+20,563652892222,321,315,1643,137.26847492784992,29.144407467532467,84,126,159,369,684
2018-05-29,7.340747157514313e+20,1119733086734,447,518,2601,266.3672597111883,57.715172195529334,150,264,319,733,1251
2018-05-30,8.585678901881907e+20,1309230109288,590,693,2929,303.05497999949785,52.04915588280767,179,331,347,857,1550
2018-05-31,7.175543486545477e+20,1093884129744,502,516,2683,240.11473665223664,57.908239538239535,136,295,285,716,1232
2018-06-01,7.579296349164774e+20,1155063747080,542,583,2872,272.1725066738817,60.643445105820106,148,283,325,756,1339
2018-06-02,3.359636534469062e+20,511859693224,245,186,959,131.55182936507936,30.78877308802309,76,118,141,335,521
2018-06-03,3.4311764480964506e+20,522587182499,341,439,2213,130.1307465127465,39.52308195045695,61,108,173,342,781
2018-06-04,7.125788220310186e+20,1084964861889,582,672,3663,256.79947195397193,53.65114707977208,133,270,307,710,1382
2018-06-05,1.0060427813477462e+21,1531271934537,712,712,4538,356.06259275182487,67.81312204429169,190,417,395,1002,1714
2018-06-06,1.916324695103136e+21,2915984541605,1333,2046,8997,691.9653951372701,143.50338263588264,372,757,779,1908,3954
2018-06-07,1.318183079363191e+21,2005230822845,874,948,5155,431.88380710757497,111.9776064028564,225,539,548,1312,2260
2018-06-08,7.477738292309336e+20,1137176394620,501,614,2843,269.4866979627515,63.74174936042793,158,279,307,744,1358
2018-06-09,3.569247299382341e+20,542633902777,340,533,2251,127.95893655947226,25.033187573009,76,125,154,355,888
2018-06-10,3.429686659222449e+20,521262828197,277,261,1605,121.5408324083324,21.181106000480998,74,124,143,341,602
2018-06-11,6.882607190184518e+20,1045657265005,352,376,2276,239.97644895382396,44.53617911255411,137,266,281,684,1060
2018-06-12,2.0463337717565256e+21,3108085492692,1310,1520,8618,714.6613652220796,129.77312117446047,390,835,808,2033,3553
2018-06-13,1.1649826295086265e+21,1768935568282,667,885,4708,405.1172953342953,67.78314326480398,251,461,445,1157,2042
2018-06-14,1.13416107177629e+21,1721633252092,724,828,3844,391.3395505493184,72.26088218923933,226,451,449,1126,1954
2018-06-15,9.914888800183089e+20,1504602984544,784,947,5989,340.292372700712,51.399187594151876,225,371,388,984,1931
2018-06-16,6.07821852320326e+20,922083511798,577,411,3050,224.09333273208273,57.32443226911977,110,214,279,603,1014
2018-06-17,6.9071820308945e+20,1047532009846,548,596,3723,265.33039788254075,48.10351596320346,151,244,290,685,1281
2018-06-18,1.549396856429454e+21,2349055517279,1101,1243,6792,544.6063297093118,102.85702928949357,303,624,609,1536,2779
2018-06-19,1.4348609605031716e+21,2174820844657,1153,1252,6226,502.6137880393416,117.70890158254444,268,572,582,1422,2674
2018-06-20,1.229486839484756e+21,1862933503833,832,768,4751,446.8193682937433,101.56627955377955,257,442,519,1218,1986
2018-06-21,1.0946082146078278e+21,1658072047159,858,943,5450,390.65794858151105,88.5399613095238,212,403,469,1084,2027
2018-06-22,1.549578786737283e+21,2346521222875,1098,1130,7661,555.6747770639854,102.33708999862571,354,564,616,1534,2664
2018-06-23,5.719411459955872e+20,865841990731,485,348,2732,197.90526403887117,38.672916048237475,121,220,225,566,914
2018-06-24,5.2767031676230035e+20,798578263669,461,429,2877,204.46045981795982,49.17628163503163,107,170,245,522,951
2018-06-25,1.1143827446514705e+21,1685985692055,593,671,3935,436.39964851781815,65.50615157824978,264,390,448,1102,1773
2018-06-26,1.1876395332897378e+21,1796247589688,910,789,5278,424.01594356040783,84.16247345412523,246,463,465,1174,1963
2018-06-27,1.181967094751668e+21,1787162165077,964,1135,6510,430.19214876789874,97.25358257747543,236,421,511,1168,2303
2018-06-28,1.259339734873392e+21,1903560698039,1001,1250,7026,454.0061880427773,87.77635686932115,259,472,513,1244,2494
2018-06-29,1.0947194956623207e+21,1654232073747,845,823,5333,392.9482932160432,79.62688795695045,201,404,476,1081,1904
2018-06-30,5.470410504842822e+20,826395636016,611,502,3759,188.02431801994302,49.60033536899608,96,206,238,540,1042
2018-07-01,1.0469015582886004e+21,1580967310289,1006,1262,6909,374.4684466984735,68.73875117640296,197,427,409,1033,2295
2018-07-02,2.50403576363733e+21,3780431034975,1779,1811,10750,815.1761979112158,190.8856349021349,422,1064,984,2470,4281
2018-07-03,1.1703752991993304e+21,1766354776021,796,829,5281,415.4723773620559,65.33159913763485,262,450,442,1154,1983
2018-07-04,6.807100982683173e+20,1027102202073,607,722,3983,258.8742452157631,53.51854707792208,155,222,294,671,1393
2018-07-05,1.768955795822679e+21,2668191287302,1866,1633,9909,638.7413835767408,113.70193104514533,358,649,736,1743,3376
2018-07-06,1.3806746729786111e+21,2081994058594,906,894,6672,509.6067019281424,88.10403810673454,295,482,583,1360,2254
2018-07-07,6.398058070192028e+20,964507625138,492,396,2845,246.3297535011285,58.9228377039627,120,204,306,630,1026
2018-07-08,5.70965606464753e+20,860454064082,545,499,3426,208.5132816773174,38.26216294750223,113,202,247,562,1061
2018-07-09,1.1931656274595904e+21,1797565113183,724,717,4322,425.027973984349,78.87226021267092,230,459,485,1174,1891
2018-07-10,1.397928584985707e+21,2105440236371,861,1163,6488,452.04371663059163,112.35423450061842,223,571,581,1375,2538
2018-07-11,1.1472126960866329e+21,1727322671779,698,731,4420,410.18710994693134,82.11073934057565,245,416,467,1128,1859
2018-07-12,9.66526955729547e+20,1454831208897,754,731,4539,340.673132530829,73.51535077488649,197,342,411,950,1681
2018-07-13,9.699291944369249e+20,1459508870731,827,568,4012,348.33313202075703,74.12993172105672,190,338,425,953,1521
2018-07-14,5.589486825265761e+20,840834151482,469,446,2704,198.28846544659044,42.54881673881674,98,209,242,549,995
2018-07-15,1.1091309325935046e+21,1667978707839,886,879,6806,421.624557040182,78.71536158286158,223,378,488,1089,1968
2018-07-16,1.2969797281164758e+21,1949910986004,1031,1130,6934,484.2982878523593,100.7130585459514,275,416,582,1273,2403
2018-07-17,1.222032333030381e+21,1836668346444,966,1062,5973,421.2489887149887,92.01183319458319,231,448,520,1199,2261
2018-07-18,1.0593221532146909e+21,1591661620730,774,826,4544,376.5431842767021,90.4125290212433,200,375,464,1039,1865
2018-07-19,3.34558767182358e+20,502502897428,315,571,2885,127.68983982683983,23.583395202020203,72,108,148,328,899
2018-07-20,1.1223122718888941e+21,1685298568736,1079,1181,6825,381.82609309671807,77.03755494505495,226,411,463,1100,2281
2018-07-21,7.358838818661254e+20,1104698405846,734,656,4542,276.9675933418433,44.085223794723795,172,237,312,721,1377
2018-07-22,6.422215866517135e+20,963794756901,537,727,4256,232.10282780843494,54.65947927601499,118,233,278,629,1356
2018-07-23,2.2490582074380318e+21,3374231875206,1947,2503,14728,751.0694527232027,133.04451449013948,458,888,856,2202,4705
2018-07-24,1.7860128124873312e+21,2678702171830,1487,1760,10107,643.1510663582449,108.82167965235821,365,672,711,1748,3508
2018-07-25,1.5403170191050565e+21,2309514501128,1271,1312,7444,537.9295816795639,114.87290357658215,320,557,630,1507,2819
2018-07-26,1.1839995997000504e+21,1774758402291,1089,1013,6768,413.27344400639043,86.12597355356283,223,438,497,1158,2171
2018-07-27,1.1650005538466843e+21,1745740812268,1133,1060,6492,421.833937450997,105.56265419699348,220,406,513,1139,2199
2018-07-28,7.141787056321994e+20,1069880284184,734,686,4306,250.32139954489955,47.942217948717946,148,249,301,698,1384
2018-07-29,6.632607211793518e+20,993298741961,784,1380,4144,238.48715513653013,53.14761426073926,134,231,283,648,2028
2018-07-30,7.229342138334371e+20,1082278439791,581,749,4613,253.12589915375628,48.78023124692768,132,273,301,706,1455
2018-07-31,1.3161973438134655e+21,1969958842303,1136,1409,7694,450.2361319738462,70.62943552908732,266,523,496,1285,2694
2018-08-01,3.673603585838143e+21,5496328729469,3476,4465,25877,1197.7564726067583,276.08176169861883,642,1492,1451,3585,8050
2018-08-02,3.185692249930499e+21,4765227319363,2381,3090,16777,1041.8917202328096,257.73595886223563,567,1251,1290,3108,6198
2018-08-03,1.424210791769575e+21,2129750092425,984,1289,6941,468.2309245430495,110.81911183261182,263,552,574,1389,2678
2018-08-04,6.308138658727394e+20,943031254680,618,980,4884,239.83095906408406,53.02615079365079,129,195,291,615,1595
2018-08-05,6.97748623847922e+20,1042764017904,474,650,3530,245.18592343304843,57.34853980543266,121,258,301,680,1330
2018-08-06,1.0634155478222809e+21,1588771057126,1011,1066,6178,367.89418818879534,72.44691753748896,208,380,448,1036,2102
2018-08-07,6.400600593331028e+21,9559330492813,5292,7286,35612,2181.6998569390266,392.4918487659827,1106,2738,2389,6233,13519
2018-08-08,4.879073203517591e+21,7285227827746,3888,5267,24331,1710.6837377711574,295.8780229466301,1000,1869,1881,4750,10017
2018-08-09,1.7130605477349776e+21,2556913363616,1420,1393,9014,575.734094596541,94.68952543091828,370,696,601,1667,3060
2018-08-10,2.686960286740693e+21,4009635876122,2196,2365,14708,939.7525407416657,143.84308267592195,598,984,1032,2614,4979
2018-08-11,1.2698708934004184e+21,1894472007143,1300,1277,7665,443.0902375204161,79.93689632457489,267,475,493,1235,2512
2018-08-12,1.0183409636039012e+21,1518738029999,866,871,5597,366.3316958610173,54.353394275367485,215,364,411,990,1861
2018-08-13,2.664106983729451e+21,3971966349736,2116,3390,15496,918.624166739125,149.7842085044585,520,1051,1018,2589,5979
2018-08-14,2.6649458159316815e+21,3972166342908,2152,2279,13450,917.3048747310891,137.1630463987071,546,1048,995,2589,4868
2018-08-15,2.5496057769531115e+21,3799028782600,1686,2273,12911,905.4664809648024,160.31679255565862,566,935,975,2476,4749
2018-08-16,2.1806758114202102e+21,3248377268746,1743,2622,12427,768.4804170531849,106.36919769714413,509,802,806,2117,4739
2018-08-17,3.636458830180789e+21,5415297971051,3193,3434,21048,1297.9587063014146,191.39702981432148,848,1267,1414,3529,6963
2018-08-18,1.1977547415256278e+21,1783193223555,1045,1188,7180,449.5966416295345,91.72895018605732,243,388,531,1162,2350
2018-08-19,1.0157035403411569e+21,1511665044435,861,977,6109,348.3585944221123,51.42041523225451,206,387,392,985,1962
2018-08-20,3.0698922833594926e+21,4567492239264,2071,2874,15186,988.8808433828076,197.31076848845598,576,1265,1135,2976,5850
2018-08-21,2.2495414464796445e+21,3345992718956,1564,2165,12311,776.6255497749605,142.29843660407053,419,893,868,2180,4345
2018-08-22,1.0446963651175677e+21,1553376016800,816,760,5266,374.79833983917314,83.39440647315647,208,369,435,1012,1772
2018-08-23,1.6439377137985664e+21,2443770572715,1489,1603,9493,588.9946183776541,115.72474864421292,314,607,671,1592,3195
2018-08-24,1.5143257264781504e+21,2250475460114,1439,1514,8527,537.3480972175972,82.32167518592519,330,556,580,1466,2980
2018-08-25,2.1740968500481756e+21,3230053867461,2191,2605,17289,753.0196382856561,120.23629015098658,462,800,842,2104,4709
2018-08-26,1.0853743509446583e+21,1612050133401,1143,1032,7088,398.98312400958827,66.28098718345147,235,346,469,1050,2082
2018-08-27,2.3576620177765743e+21,3500654169364,2013,2966,16019,827.3900183520184,151.08965246658104,514,853,913,2280,5246
2018-08-28,1.7782024594002658e+21,2639463824288,1511,1712,9913,615.1225737556094,123.95708418895919,370,619,730,1719,3431
2018-08-29,1.6732723761894832e+21,2482985375605,1292,1275,8307,567.0917474754082,103.80802564498993,329,619,669,1617,2892
2018-08-30,1.424368293822266e+21,2113032789181,1304,1115,7176,496.54698943318584,103.49728161653161,282,527,567,1376,2491
2018-08-31,1.384468803468876e+21,2053255445381,1129,1272,7658,477.87700302904767,91.2253392615982,278,537,522,1337,2609
2018-09-01,6.018354905089056e+20,892301882498,557,667,4601,231.80249814999814,36.342307484182484,136,187,258,581,1248
2018-09-02,6.352105789128924e+20,941501842822,626,657,3665,248.0446985838236,41.75867154142154,155,186,272,613,1270
2018-09-03,6.561672578282043e+20,972275003908,649,643,3651,241.71755103340223,54.98452410486339,125,213,295,633,1276
2018-09-04,1.5917747221623674e+21,2357870352843,1423,1380,8987,559.7774101771245,85.81064467807325,340,559,636,1535,2915
2018-09-05,1.807006810118552e+21,2675974521086,1306,1363,8965,574.9122009650403,109.84663801178979,338,754,650,1742,3105
2018-09-06,1.584556084862122e+21,2345838615806,1377,1925,10439,549.979146224807,115.5305924145299,324,573,630,1527,3452
2018-09-07,2.1364493929738923e+21,3161791605423,1940,2188,14092,707.7556003080012,176.96835688049325,350,834,874,2058,4246
2018-09-08,1.2128129645575956e+21,1794516393542,1189,1053,7457,421.75125369405725,106.95215232783089,209,422,537,1168,2221
2018-09-09,1.0044991960989409e+21,1485794691053,1158,1132,7473,368.98205568769856,69.06826203360131,210,329,428,967,2099
2018-09-10,1.788390321077552e+21,2644470469761,1268,1565,9686,628.6523036761519,133.00316037533895,329,619,773,1721,3286
2018-09-11,1.6184993197409656e+21,2392596362852,1498,1257,8963,558.2422790195915,108.53242765105264,333,576,648,1557,2814
2018-09-12,1.568133206945386e+21,2317435232066,1260,1374,9303,528.9650678541036,100.92909053545661,299,582,627,1508,2882
2018-09-13,1.3720611956570752e+21,2027098211616,1033,1013,7098,492.0063029100529,111.86310966810966,264,460,595,1319,2332
2018-09-14,1.4391414293824516e+21,2125576823976,1322,1279,9016,502.89596153912225,88.75897477346287,305,500,578,1383,2662
2018-09-15,6.630769983023852e+20,979077754298,640,659,4547,256.3587145863396,45.32218578643578,149,202,286,637,1296
2018-09-16,7.362098956361235e+20,1086732443976,793,837,5798,274.83874696533627,58.777554421768706,148,231,328,707,1544
2018-09-17,1.7416801447185518e+21,2570180982145,1427,2028,12696,534.0367518883234,103.89730477921549,278,733,661,1672,3700
2018-09-18,2.798961809587414e+21,4129135238199,2452,2767,14276,987.231240014615,75.16142132096297,774,940,972,2686,5453
2018-09-19,1.8252302606150143e+21,2691918845018,1363,1473,10202,649.6887611746719,89.35313514825121,438,621,692,1751,3224
2018-09-20,1.297203417073764e+21,1912588103366,1052,1385,8138,437.01170626067056,91.45935432556861,259,477,508,1244,2629
2018-09-21,1.1839378884605711e+21,1745100484775,1080,1057,7489,417.123536028786,109.84098863636363,223,403,509,1135,2192
2018-09-22,8.06602312027981e+20,1188578412154,793,748,5777,324.18811738922454,67.53418766352695,177,227,369,773,1521
2018-09-23,7.15038854538057e+20,1053330504992,895,1256,7726,288.27212280180134,56.15757505325362,153,202,330,685,1941
2018-09-24,1.1079190271508602e+21,1631602387795,995,1313,8250,396.52171403266044,83.14955156021227,215,371,475,1061,2374
2018-09-25,1.1814125001218843e+21,1739343045389,962,1032,6704,418.31258578788936,77.70222401540259,255,405,471,1131,2163
2018-09-26,8.976447562817841e+20,1321124430141,832,1702,5395,306.8120230379189,66.0774669011544,156,332,371,859,2561
2018-09-27,3.1936266517037727e+21,4698810774526,2778,4409,17926,1197.7510336376586,140.30416686620256,935,1007,1113,3055,7464
2018-09-28,4.882118771845065e+21,7181558314939,4134,4932,27404,1747.463601196643,270.77675567421994,1345,1563,1761,4669,9601
2018-09-29,1.8117527276994945e+21,2664217686260,1835,2170,13268,704.4714465679823,116.78013623083265,466,484,782,1732,3902
2018-09-30,2.040370540320021e+21,2999690444680,1902,2131,14512,751.2931973958581,156.7278102984978,454,607,889,1950,4081
2018-10-01,2.860755290651172e+21,4204443195947,1950,3031,18049,1006.7832436265234,223.13313695002086,574,960,1199,2733,5764
2018-10-02,2.303645070367986e+21,3384668727590,1878,2288,13319,776.9448992327117,170.01097167217702,438,826,936,2200,4488
2018-10-03,1.6120435230089512e+21,2367858151438,1355,1504,9755,558.1137260614165,121.21591295642187,341,539,659,1539,3043
2018-10-04,2.421658488057498e+21,3555866001072,2072,1947,14741,844.6833718140325,149.22527814216207,558,847,906,2311,4258
2018-10-05,3.0334462574791056e+21,4453118361680,2449,2466,18491,1062.8232789584754,162.44928386560528,735,1040,1119,2894,5360
2018-10-06,3.827508381384373e+20,561679676535,558,512,4535,143.8527572890073,20.101585983460982,86,116,163,365,877
2018-10-07,8.527668567918906e+20,1251138296280,1049,928,6935,317.2320763680764,69.58221778221778,183,257,373,813,1741
2018-10-08,2.0734162498962362e+21,3041078865097,1741,1870,12973,693.8835455724831,154.27102027998455,368,786,822,1976,3846
2018-10-09,1.8431840120297714e+21,2702643527778,1578,1677,10616,615.1469152652902,155.39013392394642,347,646,763,1756,3433
2018-10-10,1.6831762555231027e+21,2467302954778,1314,1444,8859,560.804212740302,115.26617208651136,296,632,675,1603,3047
2018-10-11,1.4568484325248755e+21,2134953842402,1300,1410,8322,514.8812932957695,98.38949865148079,312,499,576,1387,2797
2018-10-12,1.3291769386984103e+21,1947276719409,1040,1270,8176,468.2730548327334,110.16621376242804,267,444,554,1265,2535
2018-10-13,7.084350612522222e+20,1037578853277,932,1631,4865,265.5511908369408,51.563044973544976,161,187,326,674,2305
2018-10-14,6.55049479560232e+20,959120155063,645,562,4472,250.41624663431807,64.04637830687831,120,196,307,623,1185
2018-10-15,1.048677344548027e+21,1534992631650,854,910,6507,365.5248748176427,79.76572426581355,179,379,439,997,1907
2018-10-16,1.3120940158692342e+21,1920004803708,947,1114,7663,498.16076127377914,101.08354635642135,282,413,552,1247,2361
2018-10-17,1.5440686394947404e+21,2258855558150,1159,1424,9943,508.7527993732458,99.0356946327482,297,539,631,1467,2891
2018-10-18,9.981705782810589e+20,1459797966465,899,906,6415,333.11836353659567,67.1109191747406,192,343,413,948,1854
2018-10-19,1.8421378552559992e+21,2693372259752,1732,1790,13940,622.3974942927442,122.2669234736824,365,613,771,1749,3539
2018-10-20,6.205721730113409e+20,907079735512,570,771,5208,221.2656113007363,46.35171833721834,131,178,280,589,1360
2018-10-21,5.4596361524278696e+20,797784386006,612,707,4528,190.62617454304953,56.51243091234162,87,175,256,518,1225
2018-10-22,9.679080821844931e+20,1413917775928,920,893,6328,342.9097192760943,69.42646862330791,185,325,408,918,1811
2018-10-23,2.1959724760637506e+21,3206915053681,2187,2437,15000,752.5718888992401,175.11013767978054,440,750,892,2082,4519
2018-10-24,2.806716554064207e+21,4097474404009,2413,3556,19038,923.6517754271742,244.8677587181337,454,1083,1123,2660,6216
2018-10-25,3.0205639821972844e+21,4408804268759,2509,2967,21712,1014.6210329334566,256.3778330541512,489,1113,1260,2862,5829
2018-10-26,2.424213620214177e+21,3537142667430,2042,3041,15640,818.1539847870383,132.16772269529412,523,846,927,2296,5337
2018-10-27,1.1543552826129862e+21,1683916373013,1263,1155,8915,405.3542040347219,86.9965283975284,225,371,497,1093,2248
2018-10-28,7.543545632680335e+20,1100080314669,747,773,5063,258.0460490243883,43.62156307581307,165,244,305,714,1487
2018-10-29,1.4426737432709604e+21,2103219963710,1186,1448,9817,464.6153412500198,112.57670722729651,242,534,589,1365,2813
2018-10-30,1.0244741009540675e+21,1493134749434,907,1073,7355,342.5128937358937,72.48198049040906,177,386,406,969,2042
2018-10-31,1.0364835336325515e+21,1510175206021,1053,1242,8483,344.12646563819777,86.56583550642479,165,387,428,980,2222
2018-11-01,1.2568917766524678e+21,1830802300783,1160,1170,8121,454.6088522535665,102.25299923489209,204,445,539,1188,2358
2018-11-02,1.3769165946957262e+21,2005056799440,1344,1928,11146,471.7534155637132,116.1896935141578,257,476,568,1301,3229
2018-11-03,6.383850193393354e+20,929370338642,712,587,4116,221.19888947097874,33.37985005668934,146,201,256,603,1190
2018-11-04,5.189407328924952e+20,755254249515,583,539,3821,194.73122712935213,45.170434796684795,96,152,242,490,1029
2018-11-05,1.0064626368915989e+21,1464352617252,876,1227,7959,353.49204326229324,67.23093617724867,200,327,423,950,2177
2018-11-06,9.283842915181262e+20,1350363501015,764,872,5497,312.5244868167547,56.69915280420637,175,322,379,876,1748
2018-11-07,7.972496224769302e+20,1159283022738,638,814,5159,264.5904705155955,65.19822835497835,123,287,342,752,1566
2018-11-08,1.0753696761453765e+21,1563266773985,873,979,6645,359.5307703493596,74.45366787775716,204,371,439,1014,1993
2018-11-09,8.593115461783019e+20,1248832166911,749,694,4432,300.4554824415003,67.77937629434058,155,294,361,810,1504
2018-11-10,4.9346903561657477e+20,716960449295,487,522,3866,179.18860028265385,42.341214079571216,92,148,225,465,987
2018-11-11,3.9172502669299443e+20,568974629730,462,626,4031,140.57727092352093,21.447982074142786,80,132,157,369,995
2018-11-12,7.943703837583624e+20,1153441218830,676,935,5268,267.34143425555925,56.21990692640692,136,285,327,748,1683
2018-11-13,8.201134943656562e+20,1190510894067,739,649,4792,278.1961766084445,55.67506912994413,159,282,331,772,1421
2018-11-14,8.18285534912385e+20,1187497404629,862,1299,4762,280.7320153259439,54.29267206503813,166,271,333,770,2069
2018-11-15,1.0736910197856074e+21,1557711211237,1015,914,5958,362.13301840223266,66.4724037268948,207,389,414,1010,1924
2018-11-16,5.923617217201305e+20,859111120604,551,541,3670,200.80395642783142,47.144316919191915,100,210,247,557,1098
2018-11-17,4.712445879410991e+20,683307358616,552,802,3421,178.3420903606975,46.06491293032364,89,134,220,443,1245
2018-11-18,4.288494273698333e+20,621646165705,545,659,4033,153.83534907222406,25.257679374197227,93,121,189,403,1062
2018-11-19,1.2582793932770005e+21,1823400124488,967,902,7115,426.0008187143544,88.01474826496255,233,434,515,1182,2084
2018-11-20,1.1383326539230042e+21,1649164241277,901,932,6732,384.07857828216754,76.30155117501546,236,390,443,1069,2001
2018-11-21,9.001166043744173e+20,1303670074992,695,713,4836,306.51380597643094,51.76375054112554,209,305,331,845,1558
2018-11-22,5.093445475953514e+20,737500320961,471,462,3236,161.9527112048005,43.59585564831993,84,184,210,478,940
2018-11-23,6.96074798075907e+20,1007566402419,537,675,4479,253.3607343384129,51.22839852607709,159,202,292,653,1328
2018-11-24,4.4464779786655564e+20,643456480374,390,299,2303,169.62054306275735,33.031167799132085,99,122,196,417,716
2018-11-25,4.074694929135752e+20,589483257651,391,433,2787,150.0506794131794,28.261334325396824,93,114,175,382,815
2018-11-26,1.2046878942943487e+21,1742314661835,1106,1380,9588,414.4869080397116,79.64177298495156,258,392,479,1129,2509
2018-11-27,1.1474545614866016e+21,1659072083354,859,942,6087,394.1018989555418,72.51944269222841,243,389,443,1075,2017
2018-11-28,9.236096301961086e+20,1335047948302,883,776,5305,317.9795775071489,66.64506121391835,186,292,387,865,1641
2018-11-29,3.3434335378636984e+20,483119014245,328,153,1441,117.44075860647288,18.92669114615543,71,104,138,313,466
2018-11-30,8.932628481500515e+20,1290436497418,816,1048,7022,305.05077990395847,52.783401532990815,189,305,342,836,1884
2018-12-01,5.119729173346178e+20,739415808101,482,453,3270,180.32103687053686,35.49840393171643,106,162,211,479,932
2018-12-02,5.0572740552140594e+20,730193752227,496,457,3036,176.45734173564531,37.33204596990311,96,160,217,473,930
2018-12-03,1.161571083930727e+21,1676614909300,832,860,5813,367.0573913368378,87.50282592936163,192,441,453,1086,1946
2018-12-04,1.170541819128187e+21,1689064379022,1136,1243,8254,379.4978445608624,71.13600946540232,237,416,441,1094,2337
2018-12-05,7.748829326344078e+20,1117863009048,741,634,4916,248.90778312164025,45.99267104720676,168,247,309,724,1358
2018-12-06,1.1670361168280258e+21,1683073214558,969,853,6928,385.2404997317497,67.79162157287158,265,382,443,1090,1943
2018-12-07,1.58621441227782e+21,2286947583059,1158,1304,8693,516.4779949924414,114.8762581254724,277,585,619,1481,2785
2018-12-08,5.6353884570781306e+20,812285327264,522,609,4711,196.74068917920704,50.50439435168006,97,164,265,526,1135
2018-12-09,5.6802931996471486e+20,818511279652,562,596,4565,195.88916070371428,50.00623784614856,90,183,257,530,1126
2018-12-10,1.485922708452935e+21,2140596855003,1417,1823,11877,517.0646251605538,84.04843882902811,333,475,578,1386,3209
2018-12-11,1.3105637490741163e+21,1887419085300,993,1380,9247,432.9189222325294,108.96639144849858,222,448,552,1222,2602
2018-12-12,9.827223169607653e+20,1414872094796,748,996,6565,318.1613583823584,58.43826641414141,164,367,385,916,1912
2018-12-13,1.29216916837741e+21,1859834445967,976,1082,7653,417.4086010715475,82.13221818525389,232,472,500,1204,2286
2018-12-14,4.047614190503639e+20,582393427672,483,399,3136,127.40186557886558,26.77386056998557,69,167,141,377,776
2018-12-15,5.98176265636382e+20,860497415911,692,563,4794,208.05709441286226,44.144973046794476,120,184,253,557,1120
2018-12-16,5.962253301158899e+20,857454606690,715,728,5492,210.20588222954294,54.13692342379842,103,181,271,555,1283
2018-12-17,9.865449259753683e+20,1418361145750,732,791,6233,319.15793617956115,60.00532879620379,191,355,372,918,1709
2018-12-18,1.218002133162081e+21,1750644363659,1011,964,6830,406.4189330378616,76.70216620570787,232,435,466,1133,2097
2018-12-19,1.3786084978155696e+21,1980972316057,1190,1197,8714,492.26680033392535,73.27257985764236,282,467,533,1282,2479
2018-12-20,1.3285348050289054e+21,1908458573592,1135,927,7652,449.6014667581096,73.81548849893493,253,472,510,1235,2162
2018-12-21,9.168392290870016e+20,1316678904253,698,712,5207,307.7254251641216,55.180285104445815,182,325,345,852,1564
2018-12-22,5.737581609768255e+20,823743646705,650,709,4490,207.63800283997307,38.797230236033805,99,183,251,533,1242
2018-12-23,4.6411114408782764e+20,666140593380,365,394,2829,163.37664538239537,43.0527693001443,72,150,209,431,825
2018-12-24,8.671507974198369e+20,1244257015184,719,676,6261,275.08223156473156,51.5422101047101,158,330,317,805,1481
2018-12-25,4.514903751970998e+20,647665547903,385,324,2600,163.25846951659452,42.19285082972583,72,138,209,419,743
2018-12-26,9.216395395240572e+20,1321689892347,676,819,5289,305.2378470643113,72.31390149797292,154,309,392,855,1674
2018-12-27,9.898533669728938e+20,1419149939541,744,752,5630,327.6073490860991,72.08290464165464,188,330,400,918,1670
2018-12-28,1.4486400273461414e+21,2076288067220,1192,1694,11267,476.65230244623103,124.00096457775028,243,496,604,1343,3037
2018-12-29,6.991764009691113e+20,1001861707322,727,786,4945,259.7069178777572,60.110747766783476,131,198,319,648,1434
2018-12-30,5.1161274825364046e+20,732885762233,532,439,3713,179.31418393114822,36.949622092523875,116,147,211,474,913
2018-12-31,9.156223636226364e+20,1311233441010,963,832,7943,308.1819259226223,87.30118303521874,146,294,408,848,1680
2019-01-01,4.7307418985923294e+20,677299394838,622,711,5332,165.77057553953983,35.97758743505172,89,160,189,438,1149
2019-01-02,1.2296263212172132e+21,1759859960932,1063,1288,9484,379.90677609757967,105.84663524636738,195,457,486,1138,2426
2019-01-03,1.414764823253623e+21,2024391200098,1262,1453,10698,451.57674134199135,87.9371516053391,261,504,544,1309,2762
2019-01-04,9.96836226673833e+20,1425970122935,714,932,5945,331.78382328385896,74.13395752164502,167,351,404,922,1854
2019-01-05,5.515777850798663e+20,788812228612,624,762,5816,188.0330652958153,38.40396933621933,96,196,218,510,1272
2019-01-06,6.036884942773739e+20,863100468616,668,791,5293,212.4367548100048,51.37681601731602,110,185,263,558,1349
2019-01-07,1.4004413129032333e+21,2001643684503,1536,1369,10666,451.6038830375973,107.08235036193965,231,497,566,1294,2663
2019-01-08,1.1356685598368618e+21,1622752372258,977,1125,7293,364.9492310120435,69.84306857329179,200,416,433,1049,2174
2019-01-09,9.768643382319696e+20,1395431754189,766,968,6153,307.9980402507545,61.3932712188605,187,340,375,902,1870
2019-01-10,1.0150827819729018e+21,1449652965340,1173,1103,8709,337.8861173257959,58.24049691534215,212,344,381,937,2040
2019-01-11,9.363255666668434e+20,1336790828854,991,1063,7480,305.34314551255625,65.34130439600082,169,321,374,864,1927
2019-01-12,6.905345223306907e+20,985624138172,1087,1709,6623,257.37413950863953,37.13171435971436,155,196,286,637,2346
2019-01-13,5.0101033466446053e+20,714891930162,556,640,4655,165.71759628598915,36.07758718133718,93,159,210,462,1102
2019-01-14,8.786905830042328e+20,1253452489332,1004,1114,6213,297.89846961537137,56.16594384484563,175,281,354,810,1924
2019-01-15,8.996007584885864e+20,1282925728178,891,935,6170,306.63637962962963,73.13904094516595,156,293,380,829,1764
2019-01-16,9.096633495449245e+20,1296924351594,941,810,6144,314.75632245069744,58.34792989417989,194,287,357,838,1648
2019-01-17,9.20819703267682e+20,1312472583342,854,903,6184,320.1358631831132,72.34557764457765,182,279,387,848,1751
2019-01-18,2.7949953994326546e+21,3982551220239,2391,2393,17560,897.9483359319252,133.89805425526853,563,1046,964,2573,4966
2019-01-19,1.0485373550480353e+21,1493716536382,997,1019,7843,369.4508971161114,69.96516583879084,220,319,426,965,1984
2019-01-20,7.728359570897498e+20,1100620117384,534,649,5185,280.47811871197587,52.903685799650084,155,225,331,711,1360
2019-01-21,8.926922421033191e+20,1270967929725,907,830,6117,303.1541691919192,54.12936766474267,195,286,340,821,1651
2019-01-22,1.2345345849986355e+21,1757163677271,1067,1075,8834,371.63576537351537,80.78591045066045,214,495,426,1135,2210
2019-01-23,1.9204746625448804e+21,2732670569648,1693,1488,11882,585.5627133036717,112.33693326118326,351,754,660,1765,3253
2019-01-24,1.4998445549220038e+21,2133605402060,1437,1296,10341,512.3665391063962,94.35826001974216,298,521,559,1378,2674
2019-01-25,1.0234535482850688e+21,1455515216458,873,782,6204,331.4383834056155,68.48148717354074,189,369,382,940,1722
2019-01-26,6.33878578850575e+20,901230385063,743,1591,6347,220.17773400541256,41.810515912658765,126,190,266,582,2173
2019-01-27,6.406331868241489e+20,910573818939,505,448,4108,218.6302273625845,47.96580680331573,122,200,266,588,1036
2019-01-28,1.2152226236534565e+21,1726782647426,1306,1068,8952,388.0493451092558,82.92489624132482,216,459,440,1115,2183
2019-01-29,1.2766643060372008e+21,1813606244557,1117,1147,8146,417.76745573606286,86.4160354222497,231,467,473,1171,2318
2019-01-30,2.554302881524548e+21,3627444773074,2244,2826,19932,798.9192671574457,141.11793420600563,504,930,908,2342,5168
2019-01-31,1.0744876722691228e+21,1525680273624,1293,1505,11910,350.5896932419432,77.13648881673882,198,369,418,985,2490
2019-02-01,1.2659359422281886e+21,1796871218585,1174,1162,8660,414.92191731681015,88.22027423502423,250,407,503,1160,2322
2019-02-02,7.45605193193932e+20,1058040418084,776,848,6221,253.74657921311493,57.17258794578437,151,226,306,683,1531
2019-02-03,5.656769745684868e+20,802484417124,736,953,4494,196.72356344052773,37.76207843743558,121,158,239,518,1471
2019-02-04,1.2562884128538503e+21,1781682718616,1240,1535,10974,382.0230771127021,84.47124025974026,211,476,463,1150,2685
2019-02-05,1.1233539553887857e+21,1592750807306,995,1022,8199,359.32793273525414,69.26436655606298,213,369,446,1028,2050
2019-02-06,1.2264735866816346e+21,1738486930850,1180,1008,8643,374.1641192326192,70.36125393587893,239,423,460,1122,2130
2019-02-07,1.1142750257301994e+21,1578986707015,1000,972,7719,370.70962174465745,89.41675078162578,192,396,431,1019,1991
2019-02-08,1.0107299213624706e+21,1431860307829,793,797,5949,305.79300266862765,68.17748217060716,152,410,362,924,1721
2019-02-09,6.313512005972972e+20,894183636251,673,589,4731,225.58060837112623,45.9398189033189,127,180,270,577,1166
2019-02-10,5.527675354959767e+20,782651712327,488,592,4301,193.67071158008656,40.9425983044733,108,160,237,505,1097
2019-02-11,1.1858353686439637e+21,1678533460650,979,1243,8283,365.40293731400874,63.04710845701917,207,458,418,1083,2326
2019-02-12,1.121603147546747e+21,1587178042294,1121,906,7567,382.90142998866213,84.87678298718477,191,385,448,1024,1930
2019-02-13,1.1427778964627397e+21,1616714360348,926,1056,7123,358.5424166587381,81.53707178932179,183,408,452,1043,2099
2019-02-14,1.0730092320928226e+21,1517594776182,981,1068,7376,346.56912986352273,52.21953376781948,230,361,388,979,2047
2019-02-15,8.190119900302775e+20,1158027400616,590,562,4509,252.3832328451971,57.17371544130472,136,293,318,747,1309
2019-02-16,4.8804260057911584e+20,689889986870,493,535,3905,161.71362043049544,38.56736562049062,81,162,202,445,980
2019-02-17,4.761389546351642e+20,672874751795,526,565,4519,163.99120656195657,33.68394927757428,85,153,196,434,999
2019-02-18,5.7398103024785785e+20,810908433135,534,694,4214,188.2510495727817,34.28795453157953,108,185,230,523,1217
2019-02-19,1.095653711943291e+21,1547481505388,1109,1078,8219,359.50150864215146,84.3613930890538,198,344,456,998,2076
2019-02-20,1.7966516729507078e+21,2536889156734,1767,1948,15403,584.2030521307396,104.5206339847322,350,588,698,1636,3584
2019-02-21,1.6533987921993804e+21,2333897626838,1414,1434,10276,520.0645436831687,80.3664003034003,337,612,556,1505,2939
2019-02-22,1.0417731990045591e+21,1470193641350,853,998,7497,327.85898539819965,67.8597913145056,179,382,387,948,1946
2019-02-23,5.0566840344831413e+20,713424830365,554,636,3690,171.85291855300784,37.045339858554144,96,154,210,460,1096
2019-02-24,5.927102163381155e+20,835995178671,723,626,5361,193.6061887048137,42.92076718651718,102,196,241,539,1165
2019-02-25,3.278291293015591e+20,462233377502,320,276,2315,105.75413173863174,19.949305056055056,65,113,120,298,574
2019-02-26,2.9136975006481997e+21,4107514629593,2796,2515,21425,990.2907777025764,108.00730897505572,824,857,967,2648,5163
2019-02-27,1.6874708013637472e+21,2378108406104,1807,1321,11373,558.4307583342584,107.72067463092462,326,576,631,1533,2854
2019-02-28,2.8652472980144055e+21,4036676792334,2570,2004,17863,841.4176333581642,169.44462867123255,479,1123,1000,2602,4606
2019-03-01,3.700849333537961e+21,5212836752729,3788,4755,28352,1184.7796800296264,209.00885797337583,743,1258,1359,3360,8115
2019-03-02,1.1800337241394719e+21,1661684221130,1600,1466,9639,391.8149439389975,85.14321182058681,221,369,481,1071,2537
2019-03-03,1.256494568621299e+21,1768843520247,1576,1249,10984,391.084309165702,83.1771637991638,233,422,485,1140,2389
2019-03-04,2.267946787166488e+21,3191854192314,2154,2510,17061,726.6113227810549,112.6005765286301,451,812,794,2057,4567
2019-03-05,2.579760313678778e+21,3629647792977,2438,2319,19064,808.2381381587988,147.1791738479774,480,949,910,2339,4658
2019-03-06,1.8446706498288828e+21,2594735832030,1737,1941,14050,606.5103851855816,110.2802340860198,378,602,692,1672,3613
2019-03-07,1.9027067208913e+21,2675592128282,2113,1882,16638,581.2566814713065,108.23029118566618,353,666,705,1724,3606
2019-03-08,1.5842667818774957e+21,2227196822962,1681,1705,14885,508.42955238214165,95.7174043747258,302,519,614,1435,3140
2019-03-09,9.000261297743634e+20,1264983454961,1335,1408,10864,301.2801921491207,67.72127831493903,166,282,367,815,2223
2019-03-10,7.20277560586724e+20,1012047955714,1064,1176,7333,243.01758088868803,56.922290275200986,139,214,299,652,1828
2019-03-11,1.7449404230635487e+21,2451096640477,1683,1479,12991,546.9681987595737,90.98072508804326,359,596,624,1579,3058
2019-03-12,3.4602545519696596e+20,485904244274,328,385,3273,121.50460168931598,20.23652460832818,76,109,128,313,698
2019-03-13,1.5370676208216952e+21,2157946092213,1808,2112,12461,494.89118034743035,90.02165176093747,325,495,570,1390,3502
2019-03-14,1.56414302226134e+21,2195333410320,1759,1780,14424,519.5480591742913,105.89794635457135,285,517,612,1414,3194
2019-03-15,3.129213104933786e+21,4390887849120,3359,3006,23482,970.4398722659615,150.84502709724137,589,1156,1083,2828,5834
2019-03-16,1.0083718533856536e+21,1414543245946,1100,1177,10571,320.66906345968846,46.044452295389796,217,341,353,911,2088
2019-03-17,8.005509466749483e+20,1122693905515,1203,1193,8682,286.78148066748065,58.02194992969993,171,210,342,723,1916
2019-03-18,1.3956540491263543e+21,1956681922759,1443,1346,11071,434.84786759052236,86.28789682143253,256,494,510,1260,2606
2019-03-19,2.0420256211670288e+21,2862179704437,2050,2139,17573,683.6042208115958,105.61719993234279,474,607,762,1843,3982
2019-03-20,1.2724048498796635e+21,1782947506683,1568,1981,11859,411.14999157059873,81.90632585370979,240,424,484,1148,3129
2019-03-21,1.542258385918832e+21,2160472502019,1517,1973,12784,498.86490941718216,96.19808883186317,315,487,589,1391,3364
2019-03-22,1.3974448615349876e+21,1957108885703,1344,1231,10839,426.2636182190825,83.29390396111825,275,482,503,1260,2491
2019-03-23,7.122666061871603e+20,997249645594,886,852,6921,238.85604717042216,38.14768969456469,161,207,274,642,1494
2019-03-24,8.323623169162888e+20,1165076871530,952,864,8245,262.33767241356526,60.944429598179596,139,278,333,750,1614
2019-03-25,1.658617624232072e+21,2320964708640,1604,1987,14671,535.4045973173652,97.9371006605828,332,551,611,1494,3481
2019-03-26,1.5713966173550559e+21,2198351637148,1685,1572,13499,491.8809450569272,86.02239435168006,323,522,570,1415,2987
2019-03-27,1.3986368593792705e+21,1956104245165,1527,2270,13469,445.00997144191786,105.12557093898165,268,458,533,1259,3529
2019-03-28,1.4368498293951486e+21,2009035316297,1671,2174,14477,460.7608343138343,92.1372226060976,274,490,529,1293,3467
2019-03-29,1.0727219622657747e+21,1499482596074,1120,1086,8946,346.24997322584824,90.25260857892107,170,354,441,965,2051
2019-03-30,2.1129948505447668e+20,295256368079,313,238,2376,60.91804954304954,10.330463564213565,40,77,73,190,428
2019-03-31,7.775288897065892e+20,1086272980022,823,941,7937,254.94466696729197,55.041460678210676,142,256,301,699,1640
2019-04-01,1.2684954632116518e+21,1771704756462,1190,1335,10194,403.8295302135034,102.85339350133992,204,424,512,1140,2475
2019-04-02,1.1553934154640532e+21,1613277959598,1399,1080,10278,375.46323164930305,83.68216256957328,198,398,442,1038,2118
2019-04-03,1.5744105684807382e+21,2197781384114,1444,1809,14056,521.8249122220373,113.97793262987012,297,520,597,1414,3223
2019-04-04,4.3537595339843604e+21,6076073075813,3529,3258,30463,1420.0653819566676,174.25235420102385,997,1402,1510,3909,7167
2019-04-05,1.866213641145845e+21,2603738586332,1671,2491,13691,606.5283234774485,100.7313277575599,374,612,689,1675,4166
2019-04-06,8.893764620526101e+20,1240534181749,1369,1621,8706,278.5393096625597,69.97666029341029,157,282,359,798,2419
2019-04-07,8.785225608529365e+20,1225058060307,942,1103,6871,280.00764968232824,61.89622447261733,160,286,342,788,1891
2019-04-08,1.5468775276999444e+21,2156418451360,1800,1928,12706,478.21643930408214,105.30017923280423,270,528,589,1387,3315
2019-04-09,1.1468483066163393e+21,1598352297146,1301,1457,9744,383.7934712489891,87.34621489158988,221,322,485,1028,2485
2019-04-10,1.2733159186860396e+21,1774142877594,1012,1072,7289,406.7942684346077,83.02458868380296,219,433,489,1141,2213
2019-04-11,1.866511190257817e+21,2599943022647,1628,1655,12607,583.9254003869808,105.46614835858585,348,645,679,1672,3327
2019-04-12,1.7878080551713684e+21,2489671449834,1672,2091,15204,575.338486081379,96.04807823228359,358,565,678,1601,3692
2019-04-13,9.104135443842444e+20,1267460007578,940,881,8421,311.0140803878661,53.95141326530612,179,291,345,815,1696
2019-04-14,1.0191008888899998e+21,1418390082304,934,1443,8166,320.0583082790226,56.07938308384737,207,327,378,912,2355
2019-04-15,1.3592168147165339e+21,1891285870230,1309,1204,10802,431.80520468750825,77.9377971321007,252,465,499,1216,2420
2019-04-16,1.3115997862146367e+21,1824513182064,1359,1316,9766,449.32033482654913,85.55611747445676,243,404,526,1173,2489
2019-04-17,6.845676139777212e+20,951980642014,536,492,4195,211.4104270024508,38.98154798409263,132,259,221,612,1104
2019-04-18,1.1636316026625937e+21,1617819766444,1611,1219,8576,376.0873926305176,92.46649642024641,199,374,467,1040,2259
2019-04-19,8.853203829241866e+20,1230545292314,777,750,5508,282.9052217157842,52.364228486790985,165,283,343,791,1541
2019-04-20,8.520188193442223e+20,1183940531608,775,1111,8469,287.26377128272964,51.1043756012506,168,255,338,761,1872
2019-04-21,1.1064894167533398e+21,1537176588990,1216,1740,11295,376.6602590211816,48.074640141604426,251,321,416,988,2728
2019-04-22,3.3308509342896426e+21,4625843125117,3128,3861,28882,1058.709750324411,214.33307848038206,553,1167,1253,2973,6834
2019-04-23,2.5921101820905867e+21,3599082521719,2130,2869,17070,850.4960906408406,208.32736449529307,439,812,1062,2313,5182
2019-04-24,3.9361967416023633e+21,5463562028468,3980,4513,34948,1193.0478756197506,214.74580364080364,690,1463,1358,3511,8024
2019-04-25,3.689426671215828e+21,5119894929643,3313,3156,24695,1181.266840109736,225.66541116192008,652,1261,1377,3290,6446
2019-04-26,3.3115312034288223e+21,4594171407904,3423,2895,22492,1058.5697056528127,172.0249734032502,676,1080,1196,2952,5847
2019-04-27,1.2275798191815642e+21,1702663297956,954,719,7255,420.4963018965162,83.85866168487597,251,318,525,1094,1813
2019-04-28,8.575816137488576e+20,1189133310077,801,801,6310,280.57509472009474,58.52497946497947,155,270,339,764,1565
2019-04-29,1.862820910593337e+21,2582308336770,1406,2036,12526,569.8935605538641,96.28713176472998,353,659,647,1659,3695
2019-04-30,6.256640852634025e+20,867051022810,661,559,5083,201.1057196969697,32.47035984848485,119,203,235,557,1116
2019-05-01,1.978620871837944e+21,2741378366335,2043,3262,14627,636.1123039823932,121.04105328864257,382,638,741,1761,5023
2019-05-02,3.214479987201092e+21,4452459777175,2551,2865,21839,955.2393005625327,163.00864423737636,580,1173,1107,2860,5725
2019-05-03,2.3936181306545254e+21,3314612693607,2030,2746,17629,715.6756324640967,158.86881674740602,406,838,885,2129,4875
2019-05-04,8.558544101063895e+20,1184855007720,985,935,5588,279.16775577200576,66.89102609427609,158,242,361,761,1696
2019-05-05,7.942610432700977e+20,1099284081128,668,706,5680,267.1788078951472,57.15772334312513,132,241,333,706,1412
2019-05-06,1.3414636907064291e+21,1856121156268,922,892,7433,389.6855257936508,92.47983014670514,212,480,500,1192,2084
2019-05-07,1.263101728522673e+21,1747219760380,967,989,8333,393.55961607704467,92.99114661925375,199,448,475,1122,2111
2019-05-08,1.2218267888161094e+21,1689692153852,1136,1176,8076,378.57516239118024,86.93571277531991,212,413,460,1085,2261
2019-05-09,1.2278530042399503e+21,1697573090448,702,726,5832,363.3963949681271,99.94206295952723,151,452,487,1090,1816
2019-05-10,1.2688243515839836e+21,1753739479947,1079,1185,9831,389.3059616124616,76.9760183982684,200,451,475,1126,2311
2019-05-11,5.793623568802504e+20,800591926633,520,587,5767,186.8151056912664,50.43987438157081,89,175,250,514,1101
2019-05-12,5.20930149685906e+20,719641184155,326,497,2988,165.0072843915344,45.1425193001443,74,183,205,462,959
2019-05-13,1.328722310317562e+21,1835039684803,931,958,6620,370.8010261530797,78.44825110405468,205,514,459,1178,2136
2019-05-14,1.1373048571069457e+21,1570300261994,1069,1098,8899,352.59395483286556,63.90432615532615,206,383,419,1008,2106
2019-05-15,1.1715461327824863e+21,1617129067512,803,1467,5917,338.40201844121486,72.63099476911977,203,435,400,1038,2505
2019-05-16,1.4157817933411613e+21,1953747741079,1217,1512,9313,398.38528684741186,95.32739158526658,220,543,491,1254,2766
2019-05-17,2.4914559612461714e+21,3437179343174,2022,1915,13826,726.1595279270994,132.3732230785088,438,936,832,2206,4121
2019-05-18,1.0065569565278128e+21,1388333841336,1102,935,8063,322.70669411805125,52.58004014636157,193,300,398,891,1826
2019-05-19,8.599993595185666e+20,1185843240648,791,716,5358,273.9926803989661,61.698741819688244,153,271,337,761,1477
2019-05-20,3.549957290858397e+20,489331759200,445,477,3538,100.67411556036556,20.908981782106782,59,132,123,314,791
2019-05-21,3.2093180799313925e+21,4422874713131,2846,2856,20173,973.1649069871927,125.88693081125223,633,1113,1092,2838,5694
2019-05-22,3.4331988847119413e+21,4730152546409,3793,3538,25668,1034.4703896136932,150.65615752963967,629,1235,1171,3035,6573
2019-05-23,3.8619459515989376e+21,5319553433183,3399,2637,21385,1220.3886834075315,226.47793365265684,727,1291,1395,3413,6050
2019-05-24,2.3498492753818183e+21,3235869131704,2490,2359,13619,697.1793107877572,121.60343902526046,476,781,819,2076,4435
2019-05-25,9.612890885161196e+20,1323410071649,865,847,6772,295.9624949904593,62.07618542964971,161,312,376,849,1696
2019-05-26,8.064271831514896e+20,1109917724742,943,961,7283,256.9673444842195,51.262561998186996,157,254,301,712,1673
2019-05-27,8.757996407911442e+20,1205076340957,938,1433,9253,293.50381257267867,72.54303140014747,134,267,372,773,2206
2019-05-28,1.5198533356948653e+21,2090688973097,1374,1848,12404,479.8516931375503,88.90386131130774,270,481,590,1341,3189
2019-05-29,1.8649992750319463e+21,2564784009658,1535,1935,14809,562.7947639113531,125.13274432115503,302,641,702,1645,3580
2019-05-30,1.5287375766649412e+21,2101828986016,1489,1768,14138,472.0363419034669,77.44809571909572,298,515,535,1348,3116
2019-05-31,1.6222561871657346e+21,2229810028139,1348,1575,11165,475.51222831004975,88.46914284855356,279,575,576,1430,3005
2019-06-01,7.205903836900198e+20,990212343984,625,766,5733,242.66821609717442,57.19536831224331,124,211,300,635,1401
2019-06-02,8.21864316980617e+20,1129064243943,851,1067,7710,262.08417146742147,66.89350155400155,128,250,346,724,1791
2019-06-03,1.1344672221762477e+21,1558024202328,1114,1167,8610,359.8259097549276,61.52474670831813,201,393,405,999,2166
2019-06-04,1.5857666908289392e+21,2177289865158,1898,1856,11566,487.7677005349148,103.49578043186972,257,562,577,1396,3252
2019-06-05,1.4850923495226097e+21,2038580919052,1083,1411,10182,475.99334927572426,121.98215246790247,240,473,594,1307,2718
2019-06-06,2.1107178298837468e+21,2896600892888,1932,1932,14460,663.5231290766112,156.90038331542794,358,691,808,1857,3789
2019-06-07,1.3257261589087778e+21,1818859326950,1219,1434,9519,419.42824037800824,96.18576503126503,228,441,497,1166,2600
2019-06-08,5.595611693678734e+20,767516586214,633,1269,7722,173.51216577404077,51.637886026011024,77,182,233,492,1761
2019-06-09,5.495104248017751e+20,753520787209,643,809,5582,177.59764598827098,43.68146076146076,87,172,224,483,1292
2019-06-10,1.1790580222868988e+21,1616342371552,828,1272,9499,358.00683676508675,90.41364638602138,197,394,445,1036,2308
2019-06-11,1.8671126593872378e+21,2558843704899,1831,2833,17345,551.6315731973053,109.53015109361537,317,680,643,1640,4473
2019-06-12,2.42672934325496e+21,3325084691815,2260,3721,18604,721.3171566555138,141.3966386464065,410,864,857,2131,5852
2019-06-13,1.251925616930186e+21,1714911963326,1433,1440,9255,400.6752379774106,84.21605493602517,222,391,486,1099,2539
2019-06-14,1.1759851645023242e+21,1610454405280,1052,1506,10552,363.3776788585092,70.19712785594035,220,388,424,1032,2538
2019-06-15,5.5169168511774124e+20,755329675159,623,1894,4327,189.52955868205868,41.16435515873016,99,155,230,484,2378
2019-06-16,6.088858439643572e+20,833407573946,508,953,5680,201.64620879352128,49.721175835738336,90,198,246,534,1487
2019-06-17,1.252406589116081e+21,1713737801051,870,1315,10134,369.9833067081728,102.57315637900459,172,457,469,1098,2413
2019-06-18,1.3212542875166808e+21,1807482469943,1039,1448,9584,403.05444467106963,83.47776255457505,257,412,489,1158,2606
2019-06-19,1.1116581951166792e+21,1520365232174,1628,1906,8160,355.46007624055835,64.90228653225081,215,355,404,974,2880
2019-06-20,1.3597686341033486e+21,1859196559870,1116,1769,12389,397.55224185999185,81.73700733988234,228,508,455,1191,2960
2019-06-21,9.993013095506999e+20,1365982600722,980,1339,7712,319.7285552542695,65.35611669084884,195,309,371,875,2214
2019-06-22,5.197967929119607e+20,710349126030,451,825,4803,151.08890838658695,37.312753684807255,84,171,200,455,1280
2019-06-23,4.6053369112066405e+20,629200282860,459,457,3301,143.57891180578682,29.149672017797016,63,155,185,403,860
2019-06-24,7.887771861341843e+20,1077355268108,622,1135,4858,252.76529455729457,50.969406366781364,134,242,314,690,1825
2019-06-25,8.86212833280785e+20,1210136709463,795,1157,7258,273.57644875098447,61.72221540232254,143,288,344,775,1932
2019-06-26,4.141094808876234e+20,565289654669,328,461,3092,145.35291971586614,25.687667620078333,75,125,162,362,823
2019-06-27,1.0447005556118609e+21,1425782353452,892,1263,7158,325.45567382617384,79.85597725422726,159,345,409,913,2176
2019-06-28,1.050742566286916e+21,1433667055938,945,1211,7724,299.6774648955542,81.76648615835222,169,369,380,918,2129
2019-06-29,4.969010183684637e+20,677824813536,560,969,4298,155.31296118563975,36.6053834921692,73,161,200,434,1403
2019-06-30,5.3372191458864293e+20,727846318467,516,1013,7082,181.37610547653404,40.89829125438054,94,140,232,466,1479
2019-07-01,1.0918470074416466e+21,1488576342482,971,1680,8572,356.15691496928997,74.407083994709,191,346,416,953,2633
2019-07-02,2.0136937180140987e+21,2744585044582,2295,3207,22495,571.6492210504442,116.49227324428217,347,734,676,1757,4964
2019-07-03,1.9878232352386379e+21,2708773836455,1784,2381,14400,629.4084263818193,134.32886681440252,345,621,768,1734,4115
2019-07-04,6.524970096463316e+20,888914510205,482,839,3790,217.83322150732866,55.61180800350443,113,194,262,569,1408
2019-07-05,8.282342896598324e+20,1128005293855,677,1042,5760,259.3576063361242,53.40692995430495,152,252,318,722,1764
2019-07-06,4.073584967511906e+20,554658249821,348,466,2555,126.68763017075517,38.87751848845598,50,135,170,355,821
2019-07-07,4.912844126614413e+20,668752700545,487,689,4108,155.62817919117919,39.93330067155067,76,150,202,428,1117
2019-07-08,8.324727097455336e+20,1132882316857,772,989,6886,258.7587859039109,62.93520492007992,132,267,326,725,1714
2019-07-09,1.0164920735808451e+21,1382969547993,828,993,7258,317.3078898185148,58.22068514818515,186,326,373,885,1878
2019-07-10,1.3603454281526076e+21,1850312233480,1101,1792,12851,391.32152165394126,83.41132076157969,215,479,490,1184,2976
2019-07-11,1.0240243181316841e+21,1392498384869,633,962,5865,303.4872783004033,59.46282162282162,159,377,355,891,1853
2019-07-12,9.42737457105833e+20,1281610803803,654,885,5481,287.52368893342106,76.44738593417165,138,316,366,820,1705
2019-07-13,5.0714804147303344e+20,689289739045,740,1921,5684,155.87241059535702,49.91973921470945,69,154,218,441,2362
2019-07-14,4.498043460593185e+20,611176187951,693,855,4704,139.201468013468,34.47041810966811,74,139,178,391,1246
2019-07-15,9.137077802933316e+20,1241179880181,720,919,7571,284.45098044217684,72.85133467326324,144,299,351,794,1713
2019-07-16,1.4768645434839165e+21,2005687217834,1049,1513,10529,456.37231010337666,63.001439756972225,297,472,514,1283,2796
2019-07-17,1.1837173946928398e+21,1607142572741,945,1606,9784,342.8236772328201,97.37574828214113,180,391,457,1028,2634
2019-07-18,8.535173022496053e+20,1158521098284,868,1326,7755,270.72293882869775,59.61340020924842,145,259,337,741,2067
2019-07-19,7.973263749827582e+20,1081971223528,622,1059,6797,247.44338732563733,60.22800036075036,134,231,327,692,1751
2019-07-20,6.477282243700288e+20,878755698377,572,1700,7827,210.6320996040996,40.748295856920855,116,195,251,562,2262
2019-07-21,4.5655927552855133e+20,619230863518,397,637,3999,144.84015555740555,32.15242371517371,78,130,188,396,1033
2019-07-22,1.009130989477423e+21,1368326179018,839,1380,8248,289.73659096921597,62.658601151824364,144,358,373,875,2255
2019-07-23,2.3536234930284744e+20,319037091624,211,394,2359,69.66360635132064,17.153413137127423,38,83,83,204,598
2019-07-24,2.616302158673195e+21,3545563929588,2285,2964,21640,717.5660803568124,173.02803797194866,377,984,906,2267,5231
2019-07-25,2.951657103342224e+21,3999280921503,2693,3500,25866,882.1028465687751,176.75482525675383,492,1008,1057,2557,6057
2019-07-26,1.3452639109508634e+21,1822228655049,969,1496,9450,386.19416634291633,80.65405109771181,216,481,468,1165,2661
2019-07-27,6.364514441826156e+20,861889919738,550,752,5537,205.2746730154766,52.78512246186353,108,194,249,551,1303
2019-07-28,5.7888071304698606e+20,783722239124,538,936,5009,185.08231782106782,36.19885088126159,96,174,231,501,1437
2019-07-29,1.214798306286317e+21,1644196043909,1092,1490,10878,361.67565289604573,80.70517924139352,171,437,443,1051,2541
2019-07-30,1.266029566885561e+21,1713119267160,1094,1609,11004,377.1844225846904,83.12904210758377,212,449,434,1095,2704
2019-07-31,1.0270177328554545e+21,1389345565636,789,1175,8284,280.9415127980485,63.18800220744863,153,356,379,888,2063
2019-08-01,1.0412226486983688e+21,1408198301192,765,1212,7726,318.2611822991823,64.01830453342953,187,330,383,900,2112
2019-08-02,9.235030338859462e+20,1248670590512,961,1342,7532,293.9281786711965,63.53972160973946,154,286,358,798,2140
2019-08-03,6.332225961026958e+20,855964762478,614,1128,4796,204.32370683020682,36.865354617604616,116,193,238,547,1675
2019-08-04,4.724546707271885e+20,638486640742,380,594,3839,163.2203527953528,37.77896776834277,76,143,189,408,1002
2019-08-05,8.81521195943847e+20,1190974446317,696,1071,6942,285.59083101422385,81.27164832852333,125,267,369,761,1832
2019-08-06,6.813311651697134e+20,920276973101,530,1105,6342,201.53965894290894,55.91713077200577,93,228,267,588,1693
2019-08-07,1.0501381404848764e+21,1418056929900,809,1198,8243,313.25598175699963,63.941601995226996,197,361,348,906,2104
2019-08-08,8.661046031763008e+20,1169255154535,635,1391,5905,259.1004429340501,60.18212699271627,135,278,334,747,2138
2019-08-09,8.014173547223874e+20,1081657754131,514,963,4401,237.9725658838516,57.33659223316366,121,240,330,691,1654
2019-08-10,3.561653208050518e+20,480588766769,256,354,2437,112.55223304473304,25.42658189033189,60,105,142,307,661
2019-08-11,3.98061925450552e+20,536975754799,467,875,3939,119.97641683713113,26.81186430632859,66,137,140,343,1218
2019-08-12,6.396619728828531e+20,862655369432,495,641,4466,214.39708122895624,44.257796717171715,105,179,267,551,1192
2019-08-13,6.65395850051031e+20,897145173298,540,866,5581,196.15878982459338,50.75980126520305,92,227,254,573,1439
2019-08-14,8.259198955332642e+20,1113276314582,652,679,6224,259.67278524782097,58.23519520757021,132,271,308,711,1390
2019-08-15,8.087435020373498e+20,1089848618629,551,664,4836,226.0959145021645,49.15838744588744,129,288,279,696,1360
2019-08-16,9.136106282109823e+20,1230846037523,546,679,5255,258.86631854256854,45.38140331890332,161,311,314,786,1465
2019-08-17,4.918135339647654e+20,662434678031,360,475,3306,147.5143743234279,30.32548214285714,71,169,183,423,898
2019-08-18,4.826794848243758e+20,649946271206,337,736,3879,123.4212987455666,23.924997861265716,78,170,167,415,1151
2019-08-19,1.0005568279068648e+21,1346949415002,463,762,4163,269.43225164187663,52.5291479076479,148,387,325,860,1622
2019-08-20,1.36285429445679e+21,1834155539141,919,1538,9286,378.9909468639826,81.20705405705405,225,481,465,1171,2709
2019-08-21,4.819792490596731e+20,648490487019,376,433,3258,133.57378508726723,34.45621549251013,73,175,166,414,847
2019-08-22,1.6885533648061103e+21,2271393206491,1146,1319,9767,494.06366776279276,80.7004997300679,292,579,579,1450,2769
2019-08-23,1.4118343695011005e+21,1898675532997,1045,1627,9382,393.85063506731365,86.46473185247292,224,515,473,1212,2839
2019-08-24,7.049659995264132e+20,947822151276,431,806,4472,188.3391281701103,37.081592584003296,120,266,219,605,1411
2019-08-25,5.67653434311163e+20,763001757648,398,745,3769,173.37905844155844,45.03996753246753,82,172,233,487,1232
2019-08-26,1.2196064812176874e+21,1638898227281,715,1106,7226,336.6995610784718,81.99586662543805,171,478,397,1046,2152
2019-08-27,9.050858742435468e+20,1215925228047,763,973,6691,261.7765635521885,53.650415764790765,139,323,314,776,1749
2019-08-28,1.2063750760366963e+21,1620277594765,821,1225,8592,338.4712185715519,73.9749547073297,176,456,402,1034,2259
2019-08-29,1.2382326365960216e+21,1662671573400,907,1304,9058,338.6917074307967,67.04632578929007,194,462,405,1061,2365
2019-08-30,1.5199770028405867e+21,2040453893627,1053,2317,13281,403.45147640520855,111.726311957523,188,604,510,1302,3619
2019-08-31,4.589304190777495e+20,615929683268,271,574,2819,138.38885927960928,29.86635245310245,66,152,175,393,967
2019-09-01,4.859489310057268e+20,652014602901,372,700,3721,147.6736447811448,32.313178661616156,75,158,183,416,1116
2019-09-02,6.461844625143227e+20,866788122106,472,1289,6565,200.67533963721465,59.56296085858585,84,198,271,553,1842
2019-09-03,1.1010721887160081e+21,1476598612368,645,1324,8243,294.15820206579133,64.5857189239332,155,422,365,942,2266
2019-09-04,1.4475308402232457e+21,1940695944150,1210,1635,9887,393.5631262773822,88.85599131358059,198,565,475,1238,2873
2019-09-05,1.2561530604684656e+21,1683698990062,757,1116,7494,334.27723928716784,79.85781128395413,168,474,432,1074,2190
2019-09-06,1.1722839228714193e+21,1570906911318,826,1382,8868,304.6929796777297,73.10892117604618,163,458,381,1002,2384
2019-09-07,7.068804550988047e+20,946989758084,532,1048,5843,189.89070152070153,50.211665834165835,101,257,246,604,1652
2019-09-08,6.4385956308914e+20,862367317958,475,905,5751,200.77718166489595,46.06119024427953,92,196,262,550,1455
2019-09-09,8.642408320630189e+20,1157211282120,699,1373,7869,262.8344776334776,49.79074693362193,143,281,314,738,2111
2019-09-10,1.0085746479087528e+21,1350149847213,652,1094,6893,307.8423188339438,60.41583405483405,176,313,372,861,1955
2019-09-11,1.1577274086196027e+21,1549392678221,764,1185,8417,335.5012022963809,88.61391498712928,161,403,424,988,2173
2019-09-12,1.0725006914515643e+21,1434988092306,907,1396,9028,307.75617106438534,78.10871946505874,155,362,398,915,2311
2019-09-13,8.664755577095172e+20,1159032917194,572,862,6097,251.2199219021719,57.48903957616457,124,308,307,739,1601
2019-09-14,5.547537139262033e+20,741882534995,409,809,4594,167.26597536722537,39.59369739057239,75,172,226,473,1282
2019-09-15,4.821955207358492e+20,644675545286,581,1526,8958,161.86971903493333,39.08366066737495,80,109,222,411,1937
2019-09-16,6.267219375792661e+20,837660030045,471,930,6474,198.45498294694724,40.944615062516846,104,193,237,534,1464
2019-09-17,7.794954395087376e+20,1041632617936,670,1101,6771,232.08960901598402,48.157250615786324,126,248,290,664,1765
2019-09-18,8.302360470761628e+20,1109150025379,773,1242,7534,236.90015828153327,46.61217526455026,130,281,296,707,1949
2019-09-19,1.1441467242056917e+21,1528111101106,984,1654,9789,340.11076915676915,92.45202924852924,173,361,440,974,2628
2019-09-20,8.460132593879904e+20,1129666460601,834,1500,4695,258.23669314019315,57.17478309190809,124,284,312,720,2220
2019-09-21,5.2421597093664653e+20,699803225401,464,882,3171,165.55657119666049,28.168871431148215,83,164,199,446,1328
2019-09-22,3.985846507330823e+20,531945042319,294,622,3035,118.4933870990121,28.75506764069264,60,130,149,339,961
2019-09-23,1.0044300097565607e+21,1340139843668,982,1786,10517,302.25996450969666,55.41438096955954,164,332,358,854,2640
2019-09-24,1.4671034221302823e+21,1956961926062,1105,1321,10883,430.91468852575997,70.03366135848279,254,491,502,1247,2568
2019-09-25,9.508926568283745e+20,1268089135234,636,1045,6341,265.8742104099604,48.74979310966811,141,353,314,808,1853
2019-09-26,1.455059430924797e+21,1939913230082,1083,1655,12167,417.08750541918397,99.53533782553426,240,483,513,1236,2891
2019-09-27,1.1787444382637691e+21,1571158383235,850,1079,7536,350.18919809291236,68.56884558959558,197,386,418,1001,2080
2019-09-28,7.962630463871726e+20,1061096346630,690,1048,7760,257.3387883386455,40.85182265254586,150,221,305,676,1724
2019-09-29,5.36120729588138e+20,714241055818,444,425,3408,168.94183232838589,33.92945477736549,100,159,196,455,880
2019-09-30,9.947978288540212e+20,1324955003042,912,1482,10169,300.9913878198521,79.6254156874871,143,305,396,844,2326
2019-10-01,1.1813899086693065e+21,1573077947486,969,1308,10633,350.9233411495911,69.04006817256817,192,407,403,1002,2310
2019-10-02,1.4612999188049436e+21,1945267583262,1403,2010,15891,444.4243140316474,82.33980988455988,258,457,524,1239,3249
2019-10-03,1.6999999415135534e+21,2262522768274,1552,2104,15045,499.0256392958893,103.70283928571428,278,534,629,1441,3545
2019-10-04,1.093956609041788e+21,1455569601362,808,997,7877,344.1265451823309,69.23408348794062,170,347,410,927,1924
2019-10-05,5.949540150466745e+20,791420917879,545,775,6980,182.74048452209166,38.977410284821,102,173,229,504,1279
2019-10-06,5.597165334464387e+20,744354598356,409,655,5522,181.18582893957893,32.97172778610278,96,167,211,474,1129
2019-10-07,9.402435810849094e+20,1250084178036,630,792,6230,293.56066783414997,59.676826011290295,154,305,337,796,1588
2019-10-08,1.2808173235333822e+21,1702467758354,964,1213,9036,386.62804925960285,73.83097827701398,216,408,460,1084,2297
2019-10-09,1.1771961362275033e+21,1564345064386,871,1481,9520,326.5738278322207,80.7218086477015,164,422,410,996,2477
2019-10-10,1.198822547226936e+21,1592700232093,962,1169,10328,359.9793902162652,67.11672006234505,204,377,433,1014,2183
2019-10-11,7.59261656741287e+20,1008454138776,619,800,5760,218.93508672015815,63.34371707525278,95,250,297,642,1442
2019-10-12,6.861280239841313e+20,911109953577,570,702,6698,210.72438244031102,38.45241112657184,117,210,253,580,1282
2019-10-13,3.8461141639791195e+20,510569874006,258,245,2621,112.59981445472516,32.97720772943987,54,103,168,325,570
2019-10-14,1.173096891526068e+21,1556923553422,800,797,7519,347.6261086889301,83.27974418504775,164,381,446,991,1788
2019-10-15,1.1284400579668062e+21,1497300805594,870,1105,8208,330.0833378645164,92.27382278237636,162,345,446,953,2058
2019-10-16,1.0778546719784724e+21,1429820405845,929,1014,7684,332.66885971171683,59.21667362399505,200,305,405,910,1924
2019-10-17,9.18254179980917e+20,1217775961817,725,1247,7106,252.34462116983545,56.05201846698275,134,319,322,775,2022
2019-10-18,9.362836174292417e+20,1241407039286,784,850,7648,267.8155372867873,52.65412968975469,153,293,344,790,1640
2019-10-19,4.1968271077403256e+20,556307736426,430,535,3693,129.9573925287675,37.81923575036075,56,117,181,354,889
2019-10-20,5.59754893370922e+20,741786074126,508,507,4306,163.0687810767275,27.570739538239536,93,177,202,472,979
2019-10-21,9.45458269451029e+20,1252616291606,812,1123,8007,263.35847774910275,60.44133582852333,144,322,331,797,1920
2019-10-22,8.401331216227883e+20,1112798506800,646,875,6941,238.3772325961076,44.04503203740703,134,288,286,708,1583
2019-10-23,3.124371182918022e+21,4137121789990,2648,3197,25735,844.3362907225049,209.68307246391174,401,1176,1055,2632,5829
2019-10-24,3.7032493023531956e+21,4902799721101,3085,4309,26660,1096.4072154853525,276.4205070247213,551,1198,1370,3119,7428
2019-10-25,3.029943513740614e+21,4010212846404,2419,2861,22391,872.6098868532262,212.19778033738748,449,1030,1072,2551,5412
2019-10-26,1.0870632596307905e+21,1438460079098,1125,2001,12151,337.18229797517296,82.61841883116882,163,312,440,915,2916
2019-10-27,7.01184551621639e+20,927588059249,686,1048,7476,220.16563388000887,58.74402874902875,112,202,276,590,1638
2019-10-28,1.388554164204497e+21,1836416360649,1046,1391,10868,398.7536877890628,88.02648555611056,229,441,498,1168,2559
2019-10-29,1.4270057261606306e+21,1886826646591,1376,1978,15530,404.52179960945136,101.82230098076526,215,451,534,1200,3178
2019-10-30,1.1693014755422461e+21,1545707975935,976,1418,9639,336.5695573474145,62.36829234257805,211,360,412,983,2401
2019-10-31,9.078832728227493e+20,1199837325186,845,903,6253,259.14246488079823,53.861441822066816,134,302,327,763,1666
2019-11-01,7.712876835058703e+20,1019054376817,660,906,6459,245.59585328329078,71.58793082611832,112,221,315,648,1554
2019-11-02,1.309728657129839e+20,172998211704,111,144,909,37.492654864976295,10.173384611420325,16,47,47,110,254
2019-11-03,3.608700700993592e+20,476555126524,390,668,4607,105.21598520923521,28.718015512265513,48,108,147,303,971
2019-11-04,1.0174301082822147e+21,1343239308686,847,1296,7609,289.48244409889054,60.08274229540301,155,358,341,854,2150
2019-11-05,8.306276121945903e+20,1096355032064,660,879,5906,222.13053364294436,47.38341044041937,116,305,276,697,1576
2019-11-06,1.2755548312240789e+21,1683169392768,914,1144,8996,387.27195215498784,103.2917263986014,169,403,498,1070,2214
2019-11-07,1.538244866822473e+21,2029343272122,1179,1781,14103,440.4345926150569,107.53457418705632,249,486,555,1290,3071
2019-11-08,1.370517243655236e+21,1807628159171,1183,1752,13114,405.40248308900095,103.17846814621164,196,419,534,1149,2901
2019-11-09,5.8105309557572534e+20,766196485842,587,1467,5837,171.9728593549308,38.45311224489796,89,177,221,487,1954
2019-11-10,4.8695482732172096e+20,641943747481,478,672,3804,140.3351806335199,46.481014100978385,60,145,203,408,1080
2019-11-11,1.2106236777237255e+21,1595513840866,973,1749,12485,348.3105595535417,82.12873443619871,188,380,446,1014,2763
2019-11-12,1.3435485817781341e+21,1770266289753,1210,1754,11397,399.50292710376044,119.19473593073593,193,415,517,1125,2879
2019-11-13,1.478918419804086e+21,1948179326263,1260,2229,11319,441.8345906170549,112.31324863033791,195,465,578,1238,3467
2019-11-14,1.1328274850056376e+21,1491902674831,1131,1687,11528,318.318996173139,69.46795293595294,165,361,422,948,2635
2019-11-15,8.666115450877755e+20,1141021649482,789,1277,8069,250.17699904724904,46.06900721500721,145,277,303,725,2002
2019-11-16,4.734895647313338e+20,623267359009,672,956,6024,142.04937434787433,31.709625263625263,81,138,177,396,1352
2019-11-17,4.329695245082847e+20,569786239467,430,725,4320,124.99663937913938,31.225156926406925,57,132,173,362,1087
2019-11-18,9.942169865882404e+20,1308061664782,952,1197,8803,295.6095850650672,72.55774240243882,152,286,393,831,2028
2019-11-19,1.253044610635049e+21,1648159333563,1067,1727,12778,362.2576909724975,91.16869884414527,182,395,470,1047,2774
2019-11-20,1.2127090995396503e+21,1594722209206,1023,1490,10255,353.77832623923695,79.65388177761392,203,358,452,1013,2503
2019-11-21,1.2933127336664527e+21,1700291556391,1271,1631,10777,370.93109575785763,89.99902041344897,198,405,477,1080,2711
2019-11-22,4.3697386187794814e+21,5743496858283,4197,4717,29287,1297.9360392695928,241.42799088015158,746,1416,1486,3648,8365
2019-11-23,1.3755452786853376e+21,1807538101182,1631,2334,12104,438.16653944137875,98.22677889868068,222,414,512,1148,3482
2019-11-24,2.0256955173674313e+20,266109455324,237,319,2937,57.215470376845374,9.352385101010102,33,69,67,169,488
2019-11-25,2.0729799847738648e+21,2722632612770,1799,3027,16238,625.5539412960176,137.5889816629078,339,656,734,1729,4756
2019-11-26,1.5638995852652912e+21,2053503523264,1825,2560,13617,462.27864425785856,97.48319612728541,237,527,540,1304,3864
2019-11-27,1.3868130919988718e+21,1820535237004,1046,1604,11190,420.22158678358676,85.75880513930514,223,445,488,1156,2760
2019-11-28,6.311982278286148e+20,828416581016,521,809,5613,198.5778219267505,57.376171751528894,92,173,261,526,1335
2019-11-29,6.830272508187151e+20,896193486922,637,1070,6952,207.23971363722256,61.48315821480107,97,203,269,569,1639
2019-11-30,4.226667362166185e+20,554441513587,301,562,2758,127.81814063251564,27.06989538239538,76,118,158,352,914
2019-12-01,4.3720396095716865e+20,573373477741,453,775,4212,124.37325336700337,32.85411976911977,65,145,154,364,1139
2019-12-02,7.797682595369939e+20,1022365138687,601,832,5984,240.00016576016574,50.364411976911974,135,239,275,649,1481
2019-12-03,1.1393641364786651e+21,1493461133991,686,1437,9181,334.00185044122543,65.13329184704185,190,357,401,948,2385
2019-12-04,1.0098648596138395e+21,1323391923193,760,1480,7046,285.492687025937,47.23330321067821,167,320,353,840,2320
2019-12-05,1.0763188224980999e+21,1410121706194,1064,1600,9443,308.6655744173155,76.05948181778538,147,349,399,895,2495
2019-12-06,1.3617343334808918e+21,1783623955670,1213,2350,12709,391.384547305208,111.8023286186917,187,433,512,1132,3482
2019-12-07,7.520414471631395e+20,984822512122,859,1682,6833,211.781397005772,55.87534361471861,115,235,275,625,2307
2019-12-08,5.536765112665755e+20,724870855198,526,965,5817,170.2382205988456,29.49438582251082,101,151,208,460,1425
2019-12-09,1.1269846529777279e+21,1475043615437,934,1271,9896,308.6430896854468,70.84106233977663,159,387,390,936,2207
2019-12-10,1.3609650101000594e+21,1780862864704,928,1501,10957,379.2949286725179,88.42873619766476,210,438,482,1130,2631
2019-12-11,1.1613870393215669e+21,1519333162801,921,1325,8816,345.73871377035664,83.84062292139077,178,361,425,964,2289
2019-12-12,1.5015604643687317e+21,1963888290136,1476,2275,15230,443.29674298320725,107.44506210684457,233,434,579,1246,3521
2019-12-13,9.245966125553961e+20,1208977435808,696,1271,8574,256.4428185511578,63.0349258142651,129,313,325,767,2038
2019-12-14,5.6191135990201064e+20,734567205962,545,1051,6831,183.751618841476,44.77161026077098,89,153,224,466,1517
2019-12-15,4.9213108035644385e+20,643177862375,677,986,4759,138.46736792374293,35.01228048340548,81,150,177,408,1394
2019-12-16,1.9776215268567603e+21,2583902237094,2045,2590,21506,583.7589102841603,152.0782891136641,273,628,738,1639,4229
2019-12-17,1.4181236830661383e+21,1852488128148,1025,1486,10953,420.1015508473008,111.5872494694459,216,422,537,1175,2661
2019-12-18,2.4617262445571075e+21,3214855785674,2159,3029,21644,733.9732862904291,167.27717994307278,370,752,917,2039,5068
2019-12-19,6.159416470073168e+20,804157769112,879,607,6572,179.14156636353064,46.35160186044114,90,203,217,510,1117
2019-12-20,1.7721839367336074e+21,2313242483193,1543,2183,15713,509.92791408987836,124.09397559781488,234,586,647,1467,3650
2019-12-21,7.383094494124086e+20,963504859078,724,1129,5475,223.53067750635608,63.93340751906823,98,217,296,611,1740
2019-12-22,6.793075867283254e+20,886284805067,674,887,5111,182.57131441706443,48.67658805083805,101,214,247,562,1449
2019-12-23,3.0264632109169687e+21,3947518998789,2710,3933,27084,857.2831180935466,236.51513717631573,373,1049,1081,2503,6436
2019-12-24,1.6037264195448338e+21,2091353349954,1563,2114,13974,470.2690114171543,118.31789721984364,238,482,606,1326,3440
2019-12-25,5.1779511079922087e+20,675073343524,520,922,5961,152.29472984158699,49.62378251906823,65,159,204,428,1350
2019-12-26,1.414745079385761e+21,1843949596401,1370,1996,11163,423.67448162551733,102.09372272634772,199,433,537,1169,3165
2019-12-27,1.5761252783491577e+21,2053840685736,1467,2357,13873,462.36774114245543,109.94048306554556,239,481,582,1302,3659
2019-12-28,7.858623805764842e+20,1023818090382,688,900,5253,235.42582515940848,62.305686716061714,112,227,310,649,1549
2019-12-29,7.65524588284048e+20,997058988274,673,839,6425,218.90984436000508,42.34836151480794,130,243,259,632,1471
2019-12-30,1.6454302627326316e+21,2142539040171,1494,2201,13014,479.70866998279496,111.28092067456353,235,508,615,1358,3559
2019-12-31,1.3646954269067465e+21,1776596925479,936,1086,9674,397.1835239073096,100.5691385624957,193,453,480,1126,2212
2020-01-01,1.6970170766777287e+19,22089693639,5,2,19,6.353896103896104,2.944098124098124,1,3,10,14,16
